はじめまして	【初めまして。】	顔文字
またあいましょう	【また会いましょう！】	顔文字
おはよう	【おはよう。】	顔文字
こんばんは	【こんばんは。】	顔文字
ごめんなさい	【ごめんなさい。】	顔文字
さようなら	【さようなら。】	顔文字
きをつけてください	【気を付けてください。】	顔文字
おやすみなさい	【おやすみなさい。】	顔文字
ただいま	【ただいま。】	顔文字
ちょっといいですか	【ちょっといいですか？】	顔文字
こんにちは	【こんにちは。】	顔文字
ありがとう	【ありがとう。】	顔文字
ゆるしてください	【許してください。】	顔文字
ざんねんです	【残念です。】	顔文字
おめでとう	【おめでとう！】	顔文字
よくやった	【よくやった！】	顔文字
やったー	【やったー！！】	顔文字
おかえり	【おかえり。】	顔文字
どういたしまして	【どういたしまして。】	顔文字
だれですか	【誰ですか？】	顔文字
どちらですか	【どちらですか？】	顔文字
どうすればいいですか	【どうすればいいですか？】	顔文字
なんですか	【何ですか？】	顔文字
もっていますか	【持っていますか？】	顔文字
どこですか	【どこですか？】	顔文字
どんなせんじゅつでいきますか	【どんな戦術でいきますか？】	顔文字
いつですか	【いつですか？】	顔文字
たすけはいりますか	【助けはいりますか？】	顔文字
れんけいわざのじゅんばんはどうしましょうか	【連携技の順番はどうしましょうか？】	顔文字
いまどんなぶきをもっていますか	【今どんな武器を持っていますか？】	顔文字
ふれんどになってくれませんか	【フレンドになってくれませんか？】	顔文字
わかりません	【わかりません。】	顔文字
いりません	【いりません。】	顔文字
はいおねがいします	【はい。お願いします。】	顔文字
わかりました	【わかりました。】	顔文字
いまいそがしいのであとにしてください	【今忙しいので、後にしてください。】	顔文字
いまはひとりでこうどうしたいんです	【今は独りで行動したいんです。】	顔文字
こたえたいけどひょうげんがわかりません	【答えたいけど表現がわかりません。】	顔文字
なるほど	【なるほど。】	顔文字
せっかくだけどえんりょします	【せっかくだけど遠慮します。】	顔文字
へぇー	【へぇー】	顔文字
えーっと	【えーっと…】	顔文字
えっ	【えっ！？】	顔文字
ほんとうに	【本当に？】	顔文字
むむむ	【むむむ。】	顔文字
もうすぐべつのよていがあるんです	【もうすぐ別の予定があるんです。】	顔文字
じぶんとおなじくらいのあいてです	【自分と同じくらいの相手です。】	顔文字
れんしゅうあいてになりません	【練習相手になりません。】	顔文字
とてもとてもつよそうなあいてです	【とてもとても強そうな相手です。】	顔文字
つよそうなあいてです	【強そうな相手です。】	顔文字
ちょうどいいあいてです	【丁度いい相手です。】	顔文字
らくなあいてです	【楽な相手です。】	顔文字
とてもつよそうなあいてです	【とても強そうな相手です。】	顔文字
はかりしれないつよさです	【計り知れない強さです。】	顔文字
ついていきます	【ついていきます。】	顔文字
しらべてみてください	【調べてみてください。】	顔文字
たいきします	【待機します。】	顔文字
えむぴーがなくなりました	【ＭＰがなくなりました！】	顔文字
ｍｐがなくなりました	【ＭＰがなくなりました！】	顔文字
じゅんびかんりょう	【準備完了！】	顔文字
ひーりんぐします	【ヒーリングします。】	顔文字
これをさきにやっつけて	【これを先にやっつけて！】	顔文字
かいふくしてください	【回復してください！】	顔文字
にげて	【にげて！】	顔文字
みつけました	【見つけました！】	顔文字
ぜんりょくでこうげきだ	【全力で攻撃だ！】	顔文字
すこしさがって	【すこし下がって。】	顔文字
れんけいじゅんびおっけー	【連携準備オッケー！】	顔文字
ほーむぽいんとをせっていします	【ホームポイントを設定します。】	顔文字
えりあじゃんぷします	【エリアジャンプします。】	顔文字
たすけて	【助けて！！】	顔文字
きゅうけいしましょう	【休憩しましょう。】	顔文字
とまって	【止まって！！】	顔文字
ぜんえい	【前衛】	顔文字
ちゅうえい	【中衛】	顔文字
こうえい	【後衛】	顔文字
ちょうかくかんち	【聴覚感知】	顔文字
しかくかんち	【視覚感知】	顔文字
きゅうかくかんち	【嗅覚感知】	顔文字
まほうかんち	【魔法感知】	顔文字
せいめいかんち	【生命感知】	顔文字
ついてきてください	【ついてきてください。】	顔文字
あーる３ぼたん	【Ｒ３ボタン】	顔文字
ｒ３ぼたん	【Ｒ３ボタン】	顔文字
さんかくぼたん	【△ボタン】	顔文字
まるぼたん	【○ボタン】	顔文字
える１ぼたん	【Ｌ１ボタン】	顔文字
ｌ１ぼたん	【Ｌ１ボタン】	顔文字
える２ぼたん	【Ｌ２ボタン】	顔文字
ｌ２ぼたん	【Ｌ２ボタン】	顔文字
える３ぼたん	【Ｌ３ボタン】	顔文字
ｌ３ぼたん	【Ｌ３ボタン】	顔文字
しかくぼたん	【□ボタン】	顔文字
あーる２ぼたん	【Ｒ２ボタン】	顔文字
ｒ２ぼたん	【Ｒ２ボタン】	顔文字
ばつぼたん	【×ボタン】	顔文字
あなろぐすてぃっく	【アナログスティック】	顔文字
すたーとぼたん	【スタートボタン】	顔文字
せれくとぼたん	【セレクトボタン】	顔文字
ほうこうきー	【方向キー】	顔文字
あーる１ぼたん	【Ｒ１ボタン】	顔文字
ｒ１ぼたん	【Ｒ１ボタン】	顔文字
ほうこうぱっど	【方向パッド】	顔文字
かくちょうたんし	【拡張端子】	顔文字
とりがー	【トリガー】	顔文字
えっくすぼっくすがいどぼたん	【Xbox ガイド ボタン】	顔文字
ｘぼｘがいどぼたん	【Xbox ガイド ボタン】	顔文字
てんきー	【テンキー】	顔文字
かーそるきー	【カーソルキー】	顔文字
たぶきー	【Tabキー】	顔文字
えんたーきー	【Enterキー】	顔文字
えんどきー	【Endキー】	顔文字
なむろっくきー	【NumLockキー】	顔文字
ふぁんくしょんきー	【ファンクションキー】	顔文字
すぺーすきー	【スペースキー】	顔文字
ばっくすぺーすきー	【Backspaceキー】	顔文字
はんかくぜんかくきー	【半角/全角キー】	顔文字
おるときー	【Altキー】	顔文字
いんさーときー	【Insertキー】	顔文字
ぺーじだうんきー	【PageDownキー】	顔文字
ほーむきー	【Homeキー】	顔文字
ぺーじあっぷきー	【PageUpキー】	顔文字
きゃっぷすろっくきー	【CapsLockキー】	顔文字
しふときー	【Shiftキー】	顔文字
えすけーぷきー	【Escキー】	顔文字
こんとろーるきー	【Ctrlキー】	顔文字
でりーときー	【Deleteキー】	顔文字
ぞくせい	【属性】	顔文字
きゃんぷ	【キャンプ】	顔文字
じょぶあびりてぃ	【ジョブアビリティ】	顔文字
じょぶ	【ジョブ】	顔文字
しょうごう	【称号】	顔文字
しぐねっと	【シグネット】	顔文字
さんかきぼう	【参加希望】	顔文字
さぽーとですく	【サポートデスク】	顔文字
さいばい	【栽培】	顔文字
こんくぇすと	【コンクェスト】	顔文字
こまんど	【コマンド】	顔文字
こじんせんせき	【個人戦績】	顔文字
ごうせい	【合成】	顔文字
こうげき	【攻撃】	顔文字
けいけんち	【経験値】	顔文字
ぱーてぃにさそう	【パーティに誘う】	顔文字
えりあ	【エリア】	顔文字
あいこん	【アイコン】	顔文字
ちゃっと	【チャット】	顔文字
あいてむ	【アイテム】	顔文字
あなほり	【穴掘り】	顔文字
あびりてぃ	【アビリティ】	顔文字
くえすと	【クエスト】	顔文字
うた	【歌】	顔文字
きゅうえんようせい	【救援要請】	顔文字
えんかくこうげき	【遠隔攻撃】	顔文字
きょうばい	【競売】	顔文字
おーとあたっく	【オートアタック】	顔文字
かいさん	【解散】	顔文字
かいぞく	【海賊】	顔文字
すきる	【スキル】	顔文字
うぇぽんすきる	【ウェポンスキル】	顔文字
りょうじかん	【領事館】	顔文字
じょぶちぇんじ	【ジョブチェンジ】	顔文字
まほう	【魔法】	顔文字
みっしょん	【ミッション】	顔文字
もーぐり	【モーグリ】	顔文字
もぐきんこ	【モグ金庫】	顔文字
ぽすと	【ポスト】	顔文字
りーじょん	【リージョン】	顔文字
ほーむぽいんと	【ホームポイント】	顔文字
れあ	【レア】	顔文字
れいあうと	【レイアウト】	顔文字
れじすと	【レジスト】	顔文字
れんけい	【連携】	顔文字
ろっくおん	【ロックオン】	顔文字
ろっといん	【ロットイン】	顔文字
もぐはうす	【モグハウス】	顔文字
だんじょん	【ダンジョン】	顔文字
わーるど	【ワールド】	顔文字
せいさん	【生産】	顔文字
せんとう	【戦闘】	顔文字
せんとうかいじょ	【戦闘解除】	顔文字
せんりひん	【戦利品】	顔文字
たーげっと	【ターゲット】	顔文字
しらべる	【調べる】	顔文字
とれーど	【トレード】	顔文字
ばざー	【バザー】	顔文字
ぱす	【パス】	顔文字
ひーりんぐ	【ヒーリング】	顔文字
ぺっとこまんど	【ペットコマンド】	顔文字
そうび	【装備】	顔文字
たーげっとへんこう	【ターゲット変更】	顔文字
かころぐ	【過去ログ】	顔文字
ゆーざーじしょ	【ユーザー辞書】	顔文字
しゅうのうかぐ	【収納家具】	顔文字
そざい	【素材】	顔文字
やだん	【矢弾】	顔文字
つりぐ	【釣具】	顔文字
けもののえさ	【獣の餌】	顔文字
りょうり	【料理】	顔文字
しょくざい	【食材】	顔文字
すいさんぶつ	【水産物】	顔文字
にくりょうり	【肉料理】	顔文字
たまごりょうり	【卵料理】	顔文字
ぎょかいりょうり	【魚介料理】	顔文字
すーぷるい	【スープ類】	顔文字
こくもつりょうり	【穀物料理】	顔文字
すぃーつ	【スィーツ】	顔文字
どりんく	【ドリンク】	顔文字
ざっか	【雑貨】	顔文字
じゅうじんせいひん	【獣人製品】	顔文字
かーど	【カード】	顔文字
にんぐ	【忍具】	顔文字
じゅぶつ	【呪物】	顔文字
れんたるはうす	【レンタルハウス】	顔文字
あうとぽすと	【アウトポスト】	顔文字
くりすたる	【クリスタル】	顔文字
じゅうじんいんしょう	【獣人印章】	顔文字
じゅうしんいんしょう	【獣神印章】	顔文字
すいじゃく	【衰弱】	顔文字
のろい	【呪い】	顔文字
びょうき	【病気】	顔文字
すいみん	【睡眠】	顔文字
くらやみ	【暗闇】	顔文字
まひ	【麻痺】	顔文字
どく	【毒】	顔文字
みりょう	【魅了】	顔文字
ちょうどひん	【調度品】	顔文字
やさいりょうり	【野菜料理】	顔文字
せきか	【石化】	顔文字
へう゛ぃ	【ヘヴィ】	顔文字
せいじゃく	【静寂】	顔文字
こんふりくと	【コンフリクト】	顔文字
ばりすた	【バリスタ】	顔文字
るーく	【ルーク】	顔文字
すかうと	【スカウト】	顔文字
すぷりんと	【スプリント】	顔文字
ぺとら	【ペトラ】	顔文字
ぺとらほり	【ペトラ掘り】	顔文字
しゅびたい	【守備隊】	顔文字
えんせいぐん	【遠征軍】	顔文字
げーとぶりーち	【ゲートブリーチ】	顔文字
ぶれんなー	【ブレンナー】	顔文字
びしーじ	【ビシージ】	顔文字
あさると	【アサルト】	顔文字
しょうしんしけん	【昇進試験】	顔文字
きんむひょうか	【勤務評価】	顔文字
ようへいかいきゅう	【傭兵階級】	顔文字
さくせんせんせき	【作戦戦績】	顔文字
こうこくぐんせんせき	【皇国軍戦績】	顔文字
ひふう	【秘封】	顔文字
いそうのげんとう	【移送の幻灯】	顔文字
まてき	【魔笛】	顔文字
まむーじゃばんこくぐん	【マムージャ蕃国軍】	顔文字
とろーるようへいだん	【トロール傭兵団】	顔文字
ししゃのぐんだん	【死者の軍団】	顔文字
ふめつたい	【不滅隊】	顔文字
ごるでぃおす	【ゴルディオス】	顔文字
おーとまとん	【オートマトン】	顔文字
ちょこぼきゅうしゃ	【チョコボ厩舎】	顔文字
いくせい	【育成】	顔文字
いくせいけいかく	【育成計画】	顔文字
じっこうにっすう	【実行日数】	顔文字
こうはい	【交配】	顔文字
せわ	【世話】	顔文字
えさ	【エサ】	顔文字
すくいぼり	【掬い掘り】	顔文字
つっつきぼり	【突っつき掘り】	顔文字
めんたる	【メンタル】	顔文字
ふぃじかる	【フィジカル】	顔文字
おでかけ	【お出かけ】	顔文字
さとおや	【里親】	顔文字
れーす	【レース】	顔文字
ちから	【力】	顔文字
じきゅうりょく	【持久力】	顔文字
はんだんりょく	【判断力】	顔文字
かんじゅせい	【感受性】	顔文字
あいじょう	【愛情】	顔文字
たいりょく	【体力】	顔文字
すたみな	【スタミナ】	顔文字
いんたい	【引退】	顔文字
ですとりあ	【デストリア】	顔文字
こーさー	【コーサー】	顔文字
ぽーるふりー	【ポールフリー】	顔文字
じぇにっと	【ジェニット】	顔文字
らうんしー	【ラウンシー】	顔文字
もぐろっかー	【モグロッカー】	顔文字
さるべーじ	【サルベージ】	顔文字
さぽーとじょぶ	【サポートジョブ】	顔文字
さんくしょん	【サンクション】	顔文字
ひーるぶれす	【ヒールブレス】	顔文字
ちょこぼれーす	【チョコボレース】	顔文字
ちょここいん	【チョココイン】	顔文字
えいんへりやる	【エインヘリヤル】	顔文字
ぐりっぷ	【グリップ】	顔文字
ぱんくらてぃおん	【パンクラティオン】	顔文字
じゅうせい	【獣性】	顔文字
ふうじゅう	【封獣】	顔文字
えふぴー	【FP】	顔文字
ｆｐ	【FP】	顔文字
ちょこぼのつどい	【チョコボの集い】	顔文字
かんぱにえ	【カンパニエ】	顔文字
れんごうぐんせんせき	【連合軍戦績】	顔文字
しき	【士気】	顔文字
かっき	【活気】	顔文字
じょうほうりょく	【情報力】	顔文字
きょてんぼうえいりょく	【拠点防衛力】	顔文字
せんりゃくぶっし	【戦略物資】	顔文字
えりあしはいりつ	【エリア支配率】	顔文字
しはいえりあ	【支配エリア】	顔文字
ひろいずむげーじ	【ヒロイズムゲージ】	顔文字
こうせんあいこん	【交戦アイコン】	顔文字
けつめいぐんあいこん	【血盟軍アイコン】	顔文字
れいやーえりあ	【レイヤーエリア】	顔文字
じょくんしんさ	【叙勲審査】	顔文字
あらいどたぐ	【アライドタグ】	顔文字
しぎる	【シギル】	顔文字
てんぽらりあいてむ	【テンポラリアイテム】	顔文字
かんぱにえおぷす	【カンパニエops】	顔文字
かんぱにえおｐｓ	【カンパニエops】	顔文字
かんぱにえばとる	【カンパニエバトル】	顔文字
けんもんじょ	【検問所】	顔文字
じょくん	【叙勲】	顔文字
いけんぐしん	【意見具申】	顔文字
えっけん	【謁見】	顔文字
せんきょうほうこく	【戦況報告】	顔文字
さくせんほうしん	【作戦方針】	顔文字
こうほうしえん	【後方支援】	顔文字
ぎじゅつりょく	【技術力】	顔文字
せいさんりょく	【生産力】	顔文字
じゅりょうけん	【受領券】	顔文字
れべるしんく	【レベルシンク】	顔文字
ふぇろー	【フェロー】	顔文字
ひくうてい	【飛空挺】	顔文字
ふね	【船】	顔文字
ちょこぼ	【チョコボ】	顔文字
えるう゛ぁーん	【エルヴァーン】	顔文字
がるか	【ガルカ】	顔文字
たるたる	【タルタル】	顔文字
ひゅーむ	【ヒューム】	顔文字
みすら	【ミスラ】	顔文字
じらーと	【ジラート】	顔文字
かいせんそくど	【回線速度】	顔文字
ぶらっくりすと	【ブラックリスト】	顔文字
ふれんどりすと	【フレンドリスト】	顔文字
こんふぃぐ	【コンフィグ】	顔文字
せつぞく	【接続】	顔文字
すくりーんしょっと	【スクリーンショット】	顔文字
ぱっち	【パッチ】	顔文字
ばーじょん	【バージョン】	顔文字
かいせんせつだん	【回線切断】	顔文字
らぐ	【ラグ】	顔文字
ふぃるた	【フィルタ】	顔文字
くらいあんと	【クライアント】	顔文字
ばっくあっぷ	【バックアップ】	顔文字
ちゃくしんきょひりすと	【着信拒否リスト】	顔文字
せーぶ	【セーブ】	顔文字
てれび	【テレビ】	顔文字
もでむ	【モデム】	顔文字
もにたー	【モニター】	顔文字
ろぐあうと	【ログアウト】	顔文字
ろぐいん	【ログイン】	顔文字
でんげん	【電源】	顔文字
でんわかいせん	【電話回線】	顔文字
はーどでぃすく	【ハードディスク】	顔文字
さーばー	【サーバー】	顔文字
まくろ	【マクロ】	顔文字
だいとうりょう	【大統領】	顔文字
こうじょうちょう	【工場長】	顔文字
しょうぐん	【将軍】	顔文字
てんしゅ	【店主】	顔文字
みこ	【神子】	顔文字
きし	【騎士】	顔文字
めんばー	【メンバー】	顔文字
ぺっと	【ペット】	顔文字
ぼす	【ボス】	顔文字
もんすたー	【モンスター】	顔文字
らすぼす	【ラスボス】	顔文字
おおぼす	【大ボス】	顔文字
のーとりあすもんすたー	【ノートリアスモンスター】	顔文字
ぎるどますたー	【ギルドマスター】	顔文字
てき	【敵】	顔文字
てんいん	【店員】	顔文字
みならい	【見習い】	顔文字
じゅうし	【銃士】	顔文字
いんちょう	【院長】	顔文字
おうじ	【王子】	顔文字
おう	【王】	顔文字
はいがーど	【ハイガード】	顔文字
ちゅうぼす	【中ボス】	顔文字
ぞくちょう	【族長】	顔文字
りーだー	【リーダー】	顔文字
おうじょ	【王女】	顔文字
たいこう	【大公】	顔文字
しろうと	【素人】	顔文字
みならい	【見習】	顔文字
とてい	【徒弟】	顔文字
かきゅうしょくにん	【下級職人】	顔文字
なとり	【名取】	顔文字
もくろく	【目録】	顔文字
いんか	【印可】	顔文字
こうてい	【高弟】	顔文字
かいでん	【皆伝】	顔文字
しはん	【師範】	顔文字
へらるど	【ヘラルド】	顔文字
しんがくせい	【神学生】	顔文字
すうききょう	【枢機卿】	顔文字
すうきけい	【枢機卿】	顔文字
にとうようへい	【二等傭兵】	顔文字
いっとうようへい	【一等傭兵】	顔文字
じょうとうようへい	【上等傭兵】	顔文字
ようへいちょう	【傭兵長】	顔文字
ごちょう	【伍長】	顔文字
ぐんそう	【軍曹】	顔文字
そうちょう	【曹長】	顔文字
とくむそうちょう	【特務曹長】	顔文字
ようへい	【傭兵】	顔文字
しょうい	【少尉】	顔文字
ちゅうい	【中尉】	顔文字
たいい	【大尉】	顔文字
あいてむ	【/item】	顔文字
おんらいん	【/online】	顔文字
うた	【/song】	顔文字
そんぐ	【/song】	顔文字
おーとたーげっと	【/autotarget】	顔文字
あのん	【/anon】	顔文字
あたっく	【/attack】	顔文字
こうげき	【/attack】	顔文字
せい	【/say】	顔文字
たーげっと	【/target】	顔文字
あしすと	【/assist】	顔文字
さーばーめっせーじ	【/servmes】	顔文字
たーげっとぴーしー	【/targetpc】	顔文字
たーげっとｐｃ	【/targetpc】	顔文字
りんくしぇる	【/linkshell】	顔文字
つり	【/fish】	顔文字
ぼらんてぃあ	【/volunteer】	顔文字
おーとぐるーぷ	【/autogroup】	顔文字
ぱーてぃ	【/party】	顔文字
ひざまずく	【/kneel】	顔文字
にーる	【/kneel】	顔文字
えこー	【/echo】	顔文字
てる	【/tell】	顔文字
じょぶあびりてぃ	【/jobability】	顔文字
ひーる	【/heal】	顔文字
たーげっとえぬぴーしー	【/targetnpc】	顔文字
たーげっとんｐｃ	【/targetnpc】	顔文字
なく	【/cry】	顔文字
くらい	【/cry】	顔文字
ろっくおん	【/lockon】	顔文字
ふぉろー	【/follow】	顔文字
おうえん	【/cheer】	顔文字
ちあー	【/cheer】	顔文字
うなずく	【/nod】	顔文字
のっど	【/nod】	顔文字
ほる	【/dig】	顔文字
でぃぐ	【/dig】	顔文字
かんげい	【/welcome】	顔文字
うぇるかむ	【/welcome】	顔文字
さようなら	【/goodbye】	顔文字
さよなら	【/goodbye】	顔文字
ぐっどばい	【/goodbye】	顔文字
ぐっばい	【/goodbye】	顔文字
さようなら	【/farewell】	顔文字
さよなら	【/farewell】	顔文字
ふぇあうぇる	【/farewell】	顔文字
さいばい	【/garden】	顔文字
がーでん	【/garden】	顔文字
ゆびさす	【/point】	顔文字
ぽいんと	【/point】	顔文字
いいえ	【/no】	顔文字
くびをよこにふる	【/no】	顔文字
のー	【/no】	顔文字
ねーむず	【/names】	顔文字
なまえ	【/names】	顔文字
わらう	【/laugh】	顔文字
らふ	【/laugh】	顔文字
けいれい	【/salute】	顔文字
さりゅーと	【/salute】	顔文字
てをふる	【/wave】	顔文字
うぇーぶ	【/wave】	顔文字
ぺっと	【/pet】	顔文字
おりる	【/dismount】	顔文字
でぃすまうんと	【/dismount】	顔文字
えんかくこうげき	【/shoot】	顔文字
しゅーと	【/shoot】	顔文字
ばーじょん	【/ver】	顔文字
せきをはずす	【/away】	顔文字
あうぇい	【/away】	顔文字
しゃうと	【/shout】	顔文字
うなずく	【/yes】	顔文字
はい	【/yes】	顔文字
いぇす	【/yes】	顔文字
よろめく	【/stagger】	顔文字
すたっがー	【/stagger】	顔文字
ていあん	【/propose】	顔文字
ぷろぽーず	【/propose】	顔文字
てれる	【/blush】	顔文字
ぶらっしゅ	【/blush】	顔文字
みつめる	【/stare】	顔文字
すてあ	【/stare】	顔文字
ぽすと	【/deliverybox】	顔文字
でりばりーぼっくす	【/deliverybox】	顔文字
さぽーとですく	【/helpdesk】	顔文字
へるぷですく	【/helpdesk】	顔文字
おどろく	【/amazed】	顔文字
あめいずど	【/amazed】	顔文字
とうひょう	【/vote】	顔文字
う゛ぉーと	【/vote】	顔文字
だまる	【/muted】	顔文字
みゅーてっど	【/muted】	顔文字
みゅーてぃっど	【/muted】	顔文字
きあいをいれる	【/psych】	顔文字
さいく	【/psych】	顔文字
ためいき	【/sigh】	顔文字
さい	【/sigh】	顔文字
たたく	【/slap】	顔文字
すらっぷ	【/slap】	顔文字
つつく	【/poke】	顔文字
ぽーく	【/poke】	顔文字
ほほえむ	【/smile】	顔文字
すまいる	【/smile】	顔文字
うんざり	【/disgusted】	顔文字
でぃすがすてっど	【/disgusted】	顔文字
でぃすがすてぃっど	【/disgusted】	顔文字
おどろく	【/surprised】	顔文字
さぷらいずど	【/surprised】	顔文字
おどる	【/dance】	顔文字
だんす	【/dance】	顔文字
おこる	【/angry】	顔文字
いかる	【/angry】	顔文字
あんぐりー	【/angry】	顔文字
うんざりする	【/upset】	顔文字
あっぷせっと	【/upset】	顔文字
なぐさめる	【/comfort】	顔文字
こんふぉーと	【/comfort】	顔文字
ぱーる	【/makelinkshell】	顔文字
めいくりんくしぇる	【/makelinkshell】	顔文字
とけい	【/clock】	顔文字
くろっく	【/clock】	顔文字
ぷれいじかん	【/playlog】	顔文字
ぷれいろぐ	【/playlog】	顔文字
ぷれいじかん	【/playtime】	顔文字
ぷれいたいむ	【/playtime】	顔文字
くえすと	【/quest】	顔文字
りーじょんじょうほう	【/regionmap】	顔文字
りーじょんまっぷ	【/regionmap】	顔文字
えもーと	【/emote】	顔文字
みっしょん	【/mission】	顔文字
ていあん	【/nominate】	顔文字
のみねーと	【/nominate】	顔文字
ぱーるはかい	【/breaklinkshell】	顔文字
ぱーるこわす	【/breaklinkshell】	顔文字
ぶれいくりんくしぇる	【/breaklinkshell】	顔文字
うぇいと	【/wait】	顔文字
よろこぶ	【/joy】	顔文字
じょい	【/joy】	顔文字
ふれんどりすと	【/friendlist】	顔文字
おじぎ	【/bow】	顔文字
ぼう	【/bow】	顔文字
ろぐあうと	【/logout】	顔文字
おーとむーぶ	【/automove】	顔文字
おーとらん	【/automove】	顔文字
ちゃっともーど	【/chatmode】	顔文字
さぽーとですく	【/supportdesk】	顔文字
さーち	【/search】	顔文字
だいじなもの	【/keyitem】	顔文字
きーあいてむ	【/keyitem】	顔文字
てをたたく	【/clap】	顔文字
くらっぷ	【/clap】	顔文字
まほう	【/magic】	顔文字
すがたをかくす	【/hide】	顔文字
りかいできない	【/huh】	顔文字
はっ	【/huh】	顔文字
くやしがる	【/fume】	顔文字
ふゅーむ	【/fume】	顔文字
といつめる	【/doubt】	顔文字
だうと	【/doubt】	顔文字
へるぷ	【/?】	顔文字
すねる	【/sulk】	顔文字
ちず	【/map】	顔文字
まっぷ	【/map】	顔文字
あわてる	【/panic】	顔文字
ぱにっく	【/panic】	顔文字
へるぷ	【/help】	顔文字
しょうさん	【/praise】	顔文字
ぷれいず	【/praise】	顔文字
こうげきかいじょ	【/attackoff】	顔文字
あたっくおふ	【/attackoff】	顔文字
もぐきんこ	【/bank】	顔文字
きんこ	【/bank】	顔文字
ぽすと	【/mailbox】	顔文字
めーるぼっくす	【/mailbox】	顔文字
さそう	【/invite】	顔文字
いんばいと	【/invite】	顔文字
あらいあんすこまんど	【/alliancecmd】	顔文字
いねむり	【/doze】	顔文字
だず	【/doze】	顔文字
うぇぽんすきる	【/weaponskill】	顔文字
どきっとする	【/shocked】	顔文字
しょっくと	【/shocked】	顔文字
にやりとする	【/grin】	顔文字
ぐりん	【/grin】	顔文字
かんがえこむ	【/think】	顔文字
しんく	【/think】	顔文字
ぱーてぃこまんど	【/partycmd】	顔文字
ことわる	【/decline】	顔文字
でくらいん	【/decline】	顔文字
ぶらっくりすと	【/blacklist】	顔文字
えんかくこうげき	【/throw】	顔文字
えんかくこうげき	【/range】	顔文字
らんだむ	【/random】	顔文字
にんじゅつ	【/ninjutsu】	顔文字
さんか	【/join】	顔文字
じょいん	【/join】	顔文字
しらべる	【/check】	顔文字
ちぇっく	【/check】	顔文字
れいあうと	【/layout】	顔文字
えくぃっぷ	【/equip】	顔文字
そうび	【/equip】	顔文字
すわる	【/sit】	顔文字
しっと	【/sit】	顔文字
ふれんどとうろく	【/befriend】	顔文字
しゅうのう	【/storage】	顔文字
すとれーじ	【/storage】	顔文字
かちどき	【/hurray】	顔文字
ふれー	【/hurray】	顔文字
なげる	【/toss】	顔文字
とす	【/toss】	顔文字
ぺとらほり	【/quarry】	顔文字
くありー	【/quarry】	顔文字
すぷりんと	【/sprint】	顔文字
るーく	【/scout】	顔文字
すかうと	【/scout】	顔文字
りきゃすと	【/recast】	顔文字
めんたー	【/mentor】	顔文字
たーげっとてき	【/targetopp】	顔文字
えるえすめっせーじ	【/lsmes】	顔文字
りんくしぇるめっせーじ	【/lsmes】	顔文字
ｌｓめっせーじ	【/lsmes】	顔文字
しゃっとだうん	【/shutdown】	顔文字
さーちこめんと	【/seacom】	顔文字
さちこ	【/seacom】	顔文字
さーちこめんととうろく	【/seacomup】	顔文字
さちことうろく	【/seacomup】	顔文字
ぶろっくえいど	【/blockaid】	顔文字
ろっかー	【/locker】	顔文字
びしーじちず	【/besiegemap】	顔文字
びしーじまっぷ	【/besiegemap】	顔文字
ぺっとむし	【/ignorepet】	顔文字
いぐのあぺっと	【/ignorepet】	顔文字
とらんすれーと	【/translate】	顔文字
まくろ	【/macro】	顔文字
かんぱにえちず	【/campaignmap】	顔文字
かんぱにえまっぷ	【/campaignmap】	顔文字
せんとうびーじーえむ	【/battlebgm】	顔文字
せんとうｂｇｍ	【/battlebgm】	顔文字
ばとるびーじーえむ	【/battlebgm】	顔文字
ばとるｂｇｍ	【/battlebgm】	顔文字
べる	【/bell】	顔文字
べるすいっち	【/bellsw】	顔文字
さっちぇる	【/satchel】	顔文字
こっち	【こっち】	顔文字
そっち	【そっち】	顔文字
みぎ	【右】	顔文字
よこ	【横】	顔文字
そとがわ	【外側】	顔文字
みなみ	【南】	顔文字
あっち	【あっち】	顔文字
した	【下】	顔文字
そくめん	【側面】	顔文字
ひだり	【左】	顔文字
うえ	【上】	顔文字
しょうめん	【正面】	顔文字
にし	【西】	顔文字
きた	【北】	顔文字
うら	【裏】	顔文字
ちゅうおう	【中央】	顔文字
ひがし	【東】	顔文字
うちがわ	【内側】	顔文字
おもて	【表】	顔文字
りんくしぇる	【リンクシェル】	顔文字
ぱーてぃ	【パーティ】	顔文字
あらいあんす	【アライアンス】	顔文字
しょぞくこく	【所属国】	顔文字
あるたなれんごう	【アルタナ連合】	顔文字
さんどりあおうこくぐん	【サンドリア王国軍】	顔文字
ばすとぅーくきょうわこくぐん	【バストゥーク共和国軍】	顔文字
うぃんだすれんぽうぐん	【ウィンダス連邦軍】	顔文字
おーくていこくぐん	【オーク帝国軍】	顔文字
くぅだふへいだん	【クゥダフ兵団】	顔文字
やぐーどきょうだんぐん	【ヤグード教団軍】	顔文字
やみのおうしんえいたい	【闇の王親衛隊】	顔文字
しーふ	【シーフ】	顔文字
ないと	【ナイト】	顔文字
あんこくきし	【暗黒騎士】	顔文字
けものつかい	【獣使い】	顔文字
せんし	【戦士】	顔文字
もんく	【モンク】	顔文字
しろまどうし	【白魔道士】	顔文字
くろまどうし	【黒魔道士】	顔文字
さむらい	【侍】	顔文字
あかまどうし	【赤魔道士】	顔文字
にんじゃ	【忍者】	顔文字
ぎんゆうしじん	【吟遊詩人】	顔文字
かりゅうど	【狩人】	顔文字
かりうど	【狩人】	顔文字
しょうかんし	【召喚士】	顔文字
りゅうきし	【竜騎士】	顔文字
あおまどうし	【青魔道士】	顔文字
こるせあ	【コルセア】	顔文字
からくりし	【からくり士】	顔文字
おどりこ	【踊り子】	顔文字
がくしゃ	【学者】	顔文字
きんようび	【金曜日】	顔文字
あさ	【朝】	顔文字
おととい	【おととい】	顔文字
きのう	【昨日】	顔文字
きょう	【今日】	顔文字
あす	【明日】	顔文字
あした	【明日】	顔文字
あさって	【あさって】	顔文字
きゅうじつ	【休日】	顔文字
どようび	【土曜日】	顔文字
ごぜん	【午前】	顔文字
もくようび	【木曜日】	顔文字
すいようび	【水曜日】	顔文字
かようび	【火曜日】	顔文字
げつようび	【月曜日】	顔文字
にちようび	【日曜日】	顔文字
ようび	【曜日】	顔文字
５がつ	【5月】	顔文字
ちょうき	【長期】	顔文字
１２がつ	【12月】	顔文字
１１がつ	【11月】	顔文字
１０がつ	【10月】	顔文字
９がつ	【9月】	顔文字
８がつ	【8月】	顔文字
ひる	【昼】	顔文字
６がつ	【6月】	顔文字
よる	【夜】	顔文字
４がつ	【4月】	顔文字
３がつ	【3月】	顔文字
２がつ	【2月】	顔文字
１がつ	【1月】	顔文字
ごご	【午後】	顔文字
やすみ	【休み】	顔文字
７がつ	【7月】	顔文字
たんき	【短期】	顔文字
らいしゅう	【来週】	顔文字
せんしゅう	【先週】	顔文字
びょう	【秒】	顔文字
ふん	【分】	顔文字
じかん	【時間】	顔文字
のこりじかん	【残り時間】	顔文字
くれませんか	【くれませんか？】	顔文字
やすくしてくれませんか	【安くしてくれませんか？】	顔文字
かってくれませんか	【買ってくれませんか？】	顔文字
うってくれませんか	【売ってくれませんか？】	顔文字
こうかんしませんか	【交換しませんか？】	顔文字
いりませんか	【いりませんか？】	顔文字
おかねがありません	【お金がありません。】	顔文字
きみにあげられるものはなさそうです	【君にあげられる物はなさそうです。】	顔文字
これをきみにあげましょう	【これを君にあげましょう。】	顔文字
ください	【ください】	顔文字
ほうしゅう	【報酬：】	顔文字
いれてください	【入れてください。】	顔文字
せきをはずします	【席を外します。】	顔文字
りーだーはだれですか	【リーダーは誰ですか？】	顔文字
さそってください	【誘ってください。】	顔文字
たんじかんでもいいんですが	【短時間でもいいんですが。】	顔文字
かいさんします	【解散します。】	顔文字
あつまってください	【集まってください。】	顔文字
あきはありますか	【空きはありますか？】	顔文字
いっしょにやりませんか	【一緒にやりませんか？】	顔文字
ひとりですか	【1人ですか？】	顔文字
１りですか	【1人ですか？】	顔文字
さんかきぼうをだしてください	【参加希望を出してください。】	顔文字
ふるめんばーなんです	【フルメンバーなんです。】	顔文字
あらいあんすをくみませんか	【アライアンスを組みませんか？】	顔文字
ぼしゅうちゅうです	【募集中です。】	顔文字
れべるさがすくないほうがいいですね	【レベル差が少ないほうがいいですね。】	顔文字
てつだってください	【手伝ってください。】	顔文字
じゃぐなーしんりん	【ジャグナー森林】	顔文字
ばたりあきゅうりょう	【バタリア丘陵】	顔文字
おるでーるしょうにゅうどう	【オルデール鍾乳洞】	顔文字
さいだんのま	【祭壇の間】	顔文字
うぃんだすきょじゅうく	【ウィンダス居住区】	顔文字
じゅのこう	【ジュノ港】	顔文字
ろらんべりーこうち	【ロランベリー耕地】	顔文字
くふぃむとう	【クフィム島】	顔文字
のーぐ	【ノーグ】	顔文字
べひーもすのなわばり	【ベヒーモスの縄張り】	顔文字
でるくふのとうじょうそう	【デルクフの塔上層】	顔文字
でるくふのとうちゅうそう	【デルクフの塔中層】	顔文字
でるくふのとうかそう	【デルクフの塔下層】	顔文字
じゅのかそう	【ジュノ下層】	顔文字
ひがしろんふぉーる	【東ロンフォール】	顔文字
ばすとぅーくきょじゅうく	【バストゥーク居住区】	顔文字
にしろんふぉーる	【西ロンフォール】	顔文字
さんどりあ	【サンドリア】	顔文字
るるでのにわ	【ル・ルデの庭】	顔文字
がるれーじゅようさい	【ガルレージュ要塞】	顔文字
しゃくらみのちかめいきゅう	【シャクラミの地下迷宮】	顔文字
ぶぶりむはんとう	【ブブリム半島】	顔文字
たろんぎだいきょうこく	【タロンギ大峡谷】	顔文字
たろんぎだいけいこく	【タロンギ大峡谷】	顔文字
にしさるたばるた	【西サルタバルタ】	顔文字
ばるがのぶたい	【バルガの舞台】	顔文字
わーるんのほこら	【ワールンの祠】	顔文字
そとほるとといせき	【外ホルトト遺跡】	顔文字
うちほるとといせき	【内ホルトト遺跡】	顔文字
とらいまらいすいろ	【トライマライ水路】	顔文字
まうら	【マウラ】	顔文字
げるすばとりで	【ゲルスバ砦】	顔文字
めりふぁとさんち	【メリファト山地】	顔文字
ぎであす	【ギデアス】	顔文字
どらぎーゆじょう	【ドラギーユ城】	顔文字
おずとろやじょう	【オズトロヤ城】	顔文字
ぼすでぃんひょうが	【ボスディン氷河】	顔文字
ずう゛ぁーるじょうがいかく	【ズヴァール城外郭】	顔文字
ひがしさるたばるた	【東サルタバルタ】	顔文字
くぅるんのだいがらん	【クゥルンの大伽藍】	顔文字
かざむ	【カザム】	顔文字
べどー	【ベドー】	顔文字
ぱしゅはうぬま	【パシュハウ沼】	顔文字
くろうらーのす	【クロウラーの巣】	顔文字
らんぐもんととうげ	【ラングモント峠】	顔文字
そろむぐげんや	【ソロムグ原野】	顔文字
だいこうぼう	【大工房】	顔文字
きたさんどりあ	【北サンドリア】	顔文字
らばお	【ラバオ】	顔文字
ぼすとーにゅかんごく	【ボストーニュ監獄】	顔文字
おんぞぞのめいろ	【オンゾゾの迷路】	顔文字
ぐすたふのどうもん	【グスタフの洞門】	顔文字
おんねんどう	【怨念洞】	顔文字
うがれぴじいん	【ウガレピ寺院】	顔文字
りゅうのねぐら	【龍のねぐら】	顔文字
うぃんだすもりのく	【ウィンダス森の区】	顔文字
いけにえのま	【生贄の間】	顔文字
うぃんだすみずのく	【ウィンダス水の区】	顔文字
せんたくのま	【宣託の間】	顔文字
ばすとぅーくこう	【バストゥーク港】	顔文字
てりがんみさき	【テリガン岬】	顔文字
ひがしあるてぱさばく	【東アルテパ砂漠】	顔文字
せいちじた	【聖地ジ・タ】	顔文字
ゆたんがだいしんりん	【ユタンガ大森林】	顔文字
よあとるだいしんりん	【ヨアトル大森林】	顔文字
にしあるてぱさばく	【西アルテパ砂漠】	顔文字
どうこくのたに	【慟哭の谷】	顔文字
ぼやーだじゅ	【ボヤーダ樹】	顔文字
うぃんだすこう	【ウィンダス港】	顔文字
ばすとぅーくこうざんく	【バストゥーク鉱山区】	顔文字
じゅの	【ジュノ】	顔文字
うぃんだす	【ウィンダス】	顔文字
じゅのきょじゅうく	【ジュノ居住区】	顔文字
ふぇいん	【フェ・イン】	顔文字
さんどりあきょじゅうく	【サンドリア居住区】	顔文字
みなみさんどりあ	【南サンドリア】	顔文字
ざるかばーど	【ザルカバード】	顔文字
じゅのじょうそう	【ジュノ上層】	顔文字
ずう゛ぁーるじょうないかく	【ズヴァール城内郭】	顔文字
らてーぬこうげん	【ラテーヌ高原】	顔文字
さんどりあこう	【サンドリア港】	顔文字
ばぅとぅーく	【バストゥーク】	顔文字
うぃんだすいしのく	【ウィンダス石の区】	顔文字
てんのとう	【天の塔】	顔文字
ばすとぅーくしょうぎょうく	【バストゥーク商業区】	顔文字
りゅうさどう	【流砂洞】	顔文字
いふりーとのかま	【イフリートの釜】	顔文字
うみへびのがんくつ	【海蛇の岩窟】	顔文字
くふたるのどうもん	【クフタルの洞門】	顔文字
ころろかのどうもん	【コロロカの洞門】	顔文字
まんげつのいずみ	【満月の泉】	顔文字
おうのま	【王の間】	顔文字
ゆぐほとのいわや	【ユグホトの岩屋】	顔文字
せるびな	【セルビナ】	顔文字
ばるくるむさきゅう	【バルクルム砂丘】	顔文字
つぇーるんこうざん	【ツェールン鉱山】	顔文字
だんぐるふのかれだに	【ダングルフの涸れ谷】	顔文字
みなみぐすたべるぐ	【南グスタベルグ】	顔文字
きたぐすたべるぐ	【北グスタベルグ】	顔文字
ほるれーのいわみね	【ホルレーの岩峰】	顔文字
ほるれーのがんほう	【ホルレーの岩峰】	顔文字
ぱるぶろこうざん	【パルブロ鉱山】	顔文字
ぐすげんこうざん	【グスゲン鉱山】	顔文字
だぼい	【ダボイ】	顔文字
こんしゅたっとこうち	【コンシュタット高地】	顔文字
えるでぃーむこふん	【エルディーム古墳】	顔文字
くびあのとうぎじょう	【ク・ビアの闘技場】	顔文字
げるすばやえいじん	【ゲルスバ野営陣】	顔文字
しゅうどうくつ	【修道窟】	顔文字
りゅうおうらんぺーるのはか	【龍王ランペールの墓】	顔文字
るおんのにわ	【ル・オンの庭】	顔文字
う゛ぇるがのんきゅうでん	【ヴェ・ルガノン宮殿】	顔文字
るあびたうしんでん	【ル・アビタウ神殿】	顔文字
らろふのげきじょう	【ラ・ロフの劇場】	顔文字
しゅくせいのざ	【宿星の座】	顔文字
らいめいのかいろう	【雷鳴の回廊】	顔文字
しんどうのかいろう	【震動の回廊】	顔文字
とっぷうのかいろう	【突風の回廊】	顔文字
しゃくねつのかいろう	【灼熱の回廊】	顔文字
かいりゅうのかいろう	【海流の回廊】	顔文字
とうけつのかいろう	【凍結の回廊】	顔文字
かみがみのま	【神々の間】	顔文字
ろめーう゛	【ロ・メーヴ】	顔文字
でゅなみすさんどりあ	【デュナミス-サンドリア】	顔文字
でゅなみすばすとぅーく	【デュナミス-バストゥーク】	顔文字
でゅなみすうぃんだす	【デュナミス-ウィンダス】	顔文字
でゅなみすじゅの	【デュナミス-ジュノ】	顔文字
でゅなみすぼすでぃん	【デュナミス-ボスディン】	顔文字
でゅなみすざるかばーど	【デュナミス-ザルカバード】	顔文字
まなくりっぱー	【マナクリッパー】	顔文字
びびきーわん	【ビビキー湾】	顔文字
あっとわちこう	【アットワ地溝】	顔文字
せんがいこく	【千骸谷】	顔文字
せんがいごく	【千骸谷】	顔文字
そじや	【ソ・ジヤ】	顔文字
いかいのくち	【異界の口】	顔文字
うるがらんさんみゃく	【ウルガラン山脈】	顔文字
ようそうごく	【熊爪嶽】	顔文字
むばるぽろすきゅうしがい	【ムバルポロス旧市街】	顔文字
むばるぽそるしんしがい	【ムバルポロス新市街】	顔文字
２７１６ごうさいせきじょう	【2716号採石場】	顔文字
たぶなじあちかごう	【タブナジア地下壕】	顔文字
るふぇーぜの	【ルフェーゼ野】	顔文字
みざれおかいがん	【ミザレオ海岸】	顔文字
うみじしのそうくつ	【海獅子の巣窟】	顔文字
うみししのそうくつ	【海獅子の巣窟】	顔文字
ふぉみゅなすいどう	【フォミュナ水道】	顔文字
れいはいどう	【礼拝堂】	顔文字
りう゛ぇーぬがんかいぐんさいとｂ０１	【リヴェーヌ岩塊群サイトB01】	顔文字
りう゛ぇーぬがんかいぐんさいとあ０１	【リヴェーヌ岩塊群サイトA01】	顔文字
ていりゅうのひせん	【帝龍の飛泉】	顔文字
ぷろみう゛ぉんほら	【プロミヴォン-ホラ】	顔文字
ほらのとう	【ホラの塔】	顔文字
ぷろみう゛ぉんでむ	【プロミヴォン-デム】	顔文字
でむのとう	【デムの塔】	顔文字
ぷろみう゛ぉんめあ	【プロミヴォン-メア】	顔文字
めあのとう	【メアの塔】	顔文字
ぷろみう゛ぉんう゛ぁず	【プロミヴォン-ヴァズ】	顔文字
う゛ぁずのとう	【ヴァズの塔】	顔文字
ふぁのえうんが	【ファノエ運河】	顔文字
ぎるどさんばし	【ギルド桟橋】	顔文字
てんいのま	【転移の間】	顔文字
あるたゆ	【アル・タユ】	顔文字
ふぞいのおうきゅう	【フ・ゾイの王宮】	顔文字
るめとのその	【ル・メトの園】	顔文字
あぶだるすのはこにわげるすば	【アブダルスの箱庭-ゲルスバ】	顔文字
てんしょうのくさり	【天象の鎖】	顔文字
てめなす	【テメナス】	顔文字
あぽりおん	【アポリオン】	顔文字
てんりんのば	【天輪の場】	顔文字
でゅなみすばるくるむ	【デュナミス-バルクルム】	顔文字
でゅなみすぶぶりむ	【デュナミス-ブブリム】	顔文字
でゅなみすくふぃむ	【デュナミス-クフィム】	顔文字
でゅなみすたぶなじあ	【デュナミス-タブナジア】	顔文字
あぶだるすのしまぷるごのるご	【アブダルスの島-プルゴノルゴ】	顔文字
がいようこうろあるざびゆき	【外洋航路：アルザビ行き】	顔文字
がいようこうろあるざびいき	【外洋航路：アルザビ行き】	顔文字
がいようこうろまうらゆき	【外洋航路：マウラ行き】	顔文字
がいようこうろまうらいき	【外洋航路：マウラ行き】	顔文字
あるざび	【アルザビ】	顔文字
あとるがんはくもん	【アトルガン白門】	顔文字
わじゃ−むじゅりん	【ワジャーム樹林】	顔文字
ばふらうだんきゅう	【バフラウ段丘】	顔文字
なしゅも	【ナシュモ】	顔文字
あらぱごあんしょういき	【アラパゴ暗礁域】	顔文字
いるるしかんしょう	【イルルシ環礁】	顔文字
ぺりきあ	【ペリキア】	顔文字
たらっかいりえ	【タラッカ入江】	顔文字
ぎんかいこうろなしゅもゆき	【銀海航路：ナシュモ行き】	顔文字
ぎんかいこうろなしゅもいき	【銀海航路：ナシュモ行き】	顔文字
ぎんかいこうろあるざびゆき	【銀海航路：アルザビ行き】	顔文字
ぎんかいこうろあるざびいき	【銀海航路：アルザビ行き】	顔文字
あしゅたりふごう	【アシュタリフ号】	顔文字
ぜおるむかざん	【ゼオルム火山】	顔文字
はるぶーん	【ハルブーン】	顔文字
れべろすかざあな	【レベロス風穴】	顔文字
れべろすふうけつ	【レベロス風穴】	顔文字
なばごしょけいじょう	【ナバゴ処刑場】	顔文字
まむーく	【マムーク】	顔文字
まむーじゃへいくんれんじょ	【マムージャ兵訓練所】	顔文字
ひすいびょう	【翡翠廟】	顔文字
えじわらどう	【エジワ蘿洞】	顔文字
るじゃわんれいくつ	【ルジャワン霊窟】	顔文字
かだーばのうきぬ	【カダーバの浮沼】	顔文字
かだーばのふしょう	【カダーバの浮沼】	顔文字
まむーじゃかんししょう	【マムージャ監視哨】	顔文字
はるぶーんかんししょう	【ハルブーン監視哨】	顔文字
あずーふとうかんししょう	【アズーフ島監視哨】	顔文字
どぅぶっかとうかんししょう	【ドゥブッカ島監視哨】	顔文字
いるるしかんしょうかんししょう	【イルルシ環礁監視哨】	顔文字
ろくもんいん	【六門院】	顔文字
こうむだいりてん	【公務代理店】	顔文字
ふうまどう	【封魔堂】	顔文字
わらーらじいん	【ワラーラ寺院】	顔文字
はざるむしけんじょう	【ハザルム試験場】	顔文字
あとるがん	【アトルガン】	顔文字
あるざだーるかいていいせきぐん	【アルザダール海底遺跡群】	顔文字
ぜおるむいこう	【ゼオルム遺構】	顔文字
あらぱごいこう	【アラパゴ遺構】	顔文字
ばふらういこう	【バフラウ遺構】	顔文字
ぎんかいいこう	【銀海遺構】	顔文字
ないずるとう	【ナイズル島】	顔文字
えいしょうちゅうです	【詠唱中です。】	顔文字
しごのじかんです	【仕事の時間です。】	顔文字
やくそくがあるんです	【約束があるんです。】	顔文字
ねむくなりました	【眠くなりました。】	顔文字
つかれました	【疲れました。】	顔文字
ようじがあるのでこれで	【用事があるので、これで。】	顔文字
たいちょうがわるいんです	【体調が悪いんです。】	顔文字
きがむきません	【気が向きません。】	顔文字
きょうみがあります	【興味があります。】	顔文字
せんとうちゅうなんです	【戦闘中なんです。】	顔文字
おかねをかせぎたいです	【お金を稼ぎたいです。】	顔文字
おぼえてないんです	【覚えてないんです。】	顔文字
しらないんです	【知らないんです。】	顔文字
つかったばかりです	【使ったばかりです。】	顔文字
けいけんちがほしいです	【経験値が欲しいです。】	顔文字
きこえていますか	【聞こえていますか？】	顔文字
すこしはなせます	【少し話せます。】	顔文字
にほんご	【日本語】	顔文字
えいご	【英語】	顔文字
すこしならりかいできます	【少しなら理解できます。】	顔文字
かんたんなたんごではなしてください	【簡単な単語で話してください。】	顔文字
にほんごははなせますか	【日本語は話せますか？】	顔文字
きいてください	【聞いてください。】	顔文字
えいごははなせますか	【英語は話せますか？】	顔文字
しょうりゃくけいではなくふるすぺるでおねがいします	【省略形ではなくフルスペルでお願いします。】	顔文字
へんじするのでちょっとまってください	【返事するのでちょっと待ってください。】	顔文字
わたしはえいごがはなせません	【私は英語が話せません。】	顔文字
わたしはにほんごがはなせません	【私は日本語が話せません。】	顔文字
ていけいぶんじしょをつかってください	【定型文辞書を使ってください。】	顔文字
ふらんすご	【フランス語】	顔文字
どいつご	【ドイツ語】	顔文字
ふらんすごははなせますか	【フランス語は話せますか？】	顔文字
どいつごははなせますか	【ドイツ語は話せますか？】	顔文字
わたしはふらんすごがはなせません	【私はフランス語が話せません。】	顔文字
わたしはどいつごがはなせません	【私はドイツ語が話せません。】	顔文字
おんらいん	【オンライン】	顔文字
せきをはずす	【席を外す】	顔文字
すがたをかくす	【姿を隠す】	顔文字
れんきんじゅつ	【錬金術】	顔文字
りょうてやり	【両手槍】	顔文字
かくとう	【格闘】	顔文字
つり	【釣り】	顔文字
かたてとう	【片手刀】	顔文字
りょうてとう	【両手刀】	顔文字
にんじゅつ	【忍術】	顔文字
かんがっき	【管楽器】	顔文字
げんがっき	【弦楽器】	顔文字
かしょう	【歌唱】	顔文字
せいれいまほう	【精霊魔法】	顔文字
じゃくたいまほう	【弱体魔法】	顔文字
きょうかまほう	【強化魔法】	顔文字
かわざいく	【革細工】	顔文字
かいふくまほう	【回復魔法】	顔文字
りょうてかま	【両手鎌】	顔文字
あんこくまほう	【暗黒魔法】	顔文字
しんせいまほう	【神聖魔法】	顔文字
りょうし	【漁師】	顔文字
たんけん	【短剣】	顔文字
がーど	【ガード】	顔文字
うけながし	【受け流し】	顔文字
たて	【盾】	顔文字
しゃげき	【射撃】	顔文字
とうてき	【投てき】	顔文字
きゅうじゅつ	【弓術】	顔文字
ちょうり	【調理】	顔文字
かじ	【鍛冶】	顔文字
ちょうきん	【彫金】	顔文字
りょうてけん	【両手剣】	顔文字
ほねざいく	【骨細工】	顔文字
りょうてこん	【両手棍】	顔文字
さいほう	【裁縫】	顔文字
もっこう	【木工】	顔文字
しょうかんまほう	【召喚魔法】	顔文字
かたてけん	【片手剣】	顔文字
かたておの	【片手斧】	顔文字
りょうておの	【両手斧】	顔文字
かたてこん	【片手棍】	顔文字
きょうばいじょ	【競売所】	顔文字
けいばいじょ	【競売所】	顔文字
ほうせきや	【宝石屋】	顔文字
ざっかや	【雑貨屋】	顔文字
しゅっちょうしょっぷ	【出張ショップ】	顔文字
たくはいさーびす	【宅配サービス】	顔文字
ぼうぐや	【防具屋】	顔文字
ふながいしゃ	【船会社】	顔文字
ふねがいしゃ	【船会社】	顔文字
れすとらん	【レストラン】	顔文字
ひくうりょこうしゃ	【飛空旅行社】	顔文字
さかば	【酒場】	顔文字
まほうや	【魔法屋】	顔文字
ちずや	【地図屋】	顔文字
ぶきや	【武器屋】	顔文字
ぼうしや	【帽子屋】	顔文字
ぎるどしょっぷ	【ギルドショップ】	顔文字
つりぐや	【釣具屋】	顔文字
りんくしぇるや	【リンクシェル屋】	顔文字
がっきや	【楽器屋】	顔文字
とくさんひんてん	【特産品店】	顔文字
おーく	【オーク】	顔文字
とら	【トラ】	顔文字
きのこ	【キノコ】	顔文字
みみず	【ミミズ】	顔文字
がいこつ	【骸骨】	顔文字
ごぶりん	【ゴブリン】	顔文字
もるぼる	【モルボル】	顔文字
さかな	【魚】	顔文字
くぅだふ	【クゥダフ】	顔文字
やぐーど	【ヤグード】	顔文字
じゅうじん	【獣人】	顔文字
らぷとぅる	【ラプトゥル】	顔文字
ひる	【ヒル】	顔文字
とんぼ	【トンボ】	顔文字
だるめる	【ダルメル】	顔文字
うさぎ	【ウサギ】	顔文字
はち	【ハチ】	顔文字
りざーど	【リザード】	顔文字
こうもり	【コウモリ】	顔文字
とり	【鳥】	顔文字
ひつじ	【羊】	顔文字
かに	【カニ】	顔文字
あんてぃか	【アンティカ】	顔文字
さはぎん	【サハギン】	顔文字
とんべり	【トンベリ】	顔文字
ぷろてす	【プロテス】	顔文字
うぃるな	【ウィルナ】	顔文字
さいれす	【サイレス】	顔文字
ばぱらいず	【バパライズ】	顔文字
へいすと	【ヘイスト】	顔文字
すろう	【スロウ】	顔文字
ばにしゅが	【バニシュガ】	顔文字
ぶりんく	【ブリンク】	顔文字
ばぶりざ	【バブリザ】	顔文字
でぃあが	【ディアガ】	顔文字
ばにしゅ	【バニシュ】	顔文字
あくあべーる	【アクアベール】	顔文字
ばえあろ	【バエアロ】	顔文字
ばすとん	【バストン】	顔文字
ばさんだ	【バサンダ】	顔文字
ばうぉた	【バウォタ】	顔文字
ばふぁいら	【バファイラ】	顔文字
ばぶりざら	【バブリザラ】	顔文字
ばえあろら	【バエアロラ】	顔文字
ばすとんら	【バストンラ】	顔文字
ばさんだら	【バサンダラ】	顔文字
ばうぉたら	【バウォタラ】	顔文字
てれぽめあ	【テレポメア】	顔文字
でぃあ	【ディア】	顔文字
ぽいぞな	【ポイゾナ】	顔文字
ぱらいず	【パライズ】	顔文字
さいれな	【サイレナ】	顔文字
ぶらいん	【ブライン】	顔文字
くえいく	【クエイク】	顔文字
ふりーず	【フリーズ】	顔文字
ふれあ	【フレア】	顔文字
えすけぷ	【エスケプ】	顔文字
とらくた	【トラクタ】	顔文字
りれいず	【リレイズ】	顔文字
ぷろてあ	【プロテア】	顔文字
けあるが	【ケアルガ】	顔文字
ぱらな	【パラナ】	顔文字
ばいお	【バイオ】	顔文字
けある	【ケアル】	顔文字
しょっくすぱいく	【ショックスパイク】	顔文字
てれぽほら	【テレポホラ】	顔文字
すとんすきん	【ストンスキン】	顔文字
すとな	【ストナ】	顔文字
でじょん	【デジョン】	顔文字
ばいんど	【バインド】	顔文字
かーず	【カーズ】	顔文字
どらうん	【ドラウン】	顔文字
うぉたが	【ウォタガ】	顔文字
てれぽう゛ぁず	【テレポヴァズ】	顔文字
でおーど	【デオード】	顔文字
すにーく	【スニーク】	顔文字
いんびじ	【インビジ】	顔文字
りふれしゅ	【リフレシュ】	顔文字
りじぇね	【リジェネ】	顔文字
しぇるら	【シェルラ】	顔文字
ふらっど	【フラッド】	顔文字
さんだが	【サンダガ】	顔文字
とるねど	【トルネド】	顔文字
えあろが	【エアロガ】	顔文字
ぽいずん	【ポイズン】	顔文字
れいず	【レイズ】	顔文字
ほーりー	【ホーリー】	顔文字
ぽいぞが	【ポイゾガ】	顔文字
ぶらいな	【ブライナ】	顔文字
ぐらびで	【グラビデ】	顔文字
ぶりざが	【ブリザガ】	顔文字
すとんが	【ストンガ】	顔文字
えんうぉーた	【エンウォータ】	顔文字
ばぶらいら	【バブライラ】	顔文字
ばさいれら	【バサイレラ】	顔文字
ばうぃるら	【バウィルラ】	顔文字
えんぶりざど	【エンブリザド】	顔文字
ばすりぷる	【バスリプル】	顔文字
えんふぁいあ	【エンファイア】	顔文字
ふぁいが	【ファイガ】	顔文字
うぉーた	【ウォータ】	顔文字
ばぱらいら	【バパライラ】	顔文字
えんさんだー	【エンサンダー】	顔文字
ばぶれくら	【バブレクラ】	顔文字
てれぽでむ	【テレポデム】	顔文字
ふぁいあ	【ファイア】	顔文字
ぶりざど	【ブリザド】	顔文字
えあろ	【エアロ】	顔文字
らすぷ	【ラスプ】	顔文字
さんだー	【サンダー】	顔文字
ばーすと	【バースト】	顔文字
すとーん	【ストーン】	顔文字
えんすとーん	【エンストーン】	顔文字
ふろすと	【フロスト】	顔文字
すたん	【スタン】	顔文字
ばーん	【バーン】	顔文字
あいすすぱいく	【アイススパイク】	顔文字
ぶれいずすぱいく	【ブレイズスパイク】	顔文字
あすぴる	【アスピル】	顔文字
どれいん	【ドレイン】	顔文字
ばぽいずん	【バポイズン】	顔文字
ちょーく	【チョーク】	顔文字
ばふぁい	【バファイ】	顔文字
すりぷる	【スリプル】	顔文字
かーずな	【カーズナ】	顔文字
しぇる	【シェル】	顔文字
ばぶらいん	【バブライン】	顔文字
ばさいれす	【バサイレス】	顔文字
ばぶれいく	【バブレイク】	顔文字
ばうぃるす	【バウィルス】	顔文字
ばすりぷら	【バスリプラ】	顔文字
えんえあろ	【エンエアロ】	顔文字
しょっく	【ショック】	顔文字
ばぽいぞら	【バポイゾラ】	顔文字
でぃすぺる	【ディスペル】	顔文字
いれーす	【イレース】	顔文字
ふぁらんくす	【ファランクス】	顔文字
てれぽるて	【テレポルテ】	顔文字
てれぽよと	【テレポヨト】	顔文字
ふらっしゅ	【フラッシュ】	顔文字
あぶぞーすと	【アブゾースト】	顔文字
あぶぞでっく	【アブゾデック】	顔文字
あぶぞばいと	【アブゾバイト】	顔文字
あぶぞあじる	【アブゾアジル】	顔文字
あぶぞいん	【アブゾイン】	顔文字
あぶぞまいん	【アブゾマイン】	顔文字
あぶぞかりす	【アブゾカリス】	顔文字
あぶぞたっく	【アブゾタック】	顔文字
どれっどすぱいく	【ドレッドスパイク】	顔文字
りぽーず	【リポーズ】	顔文字
かもんのけい	【火門の計】	顔文字
すいもんのけい	【水門の計】	顔文字
らいもんのけい	【雷門の計】	顔文字
ひょうもんのけい	【氷門の計】	顔文字
どもんのけい	【土門の計】	顔文字
ふうもんのけい	【風門の計】	顔文字
ひょうもんのけい	【光門の計】	顔文字
あんもんのけい	【闇門の計】	顔文字
ねっぱのじん	【熱波の陣】	顔文字
ごううのじん	【豪雨の陣】	顔文字
しつらいのじん	【疾雷の陣】	顔文字
ふぶきのじん	【吹雪の陣】	顔文字
さじんのじん	【砂塵の陣】	顔文字
れっぷうのじん	【烈風の陣】	顔文字
きょっこうのじん	【極光の陣】	顔文字
ようむのじん	【妖霧の陣】	顔文字
りこーるじゃぐ	【リコールジャグ】	顔文字
りこーるぱしゅ	【リコールパシュ】	顔文字
りこーるめりふぁ	【リコールメリファ】	顔文字
りとれーす	【リトレース】	顔文字
きょゆうえんさつのさく	【虚誘掩殺の策】	顔文字
あぶぞあきゅる	【アブゾアキュル】	顔文字
りあくと	【リアクト】	顔文字
けあるら	【ケアルラ】	顔文字
さくりふぁいす	【サクリファイス】	顔文字
えすな	【エスナ】	顔文字
おーすぴす	【オースピス】	顔文字
まーち	【マーチ】	顔文字
えれじー	【エレジー】	顔文字
えちゅーど	【エチュード】	顔文字
かろる	【カロル】	顔文字
ふぃなーれ	【フィナーレ】	顔文字
れくいえむ	【レクイエム】	顔文字
がぼっと	【ガボット】	顔文字
すれのでぃ	【スレノディ】	顔文字
はみんぐ	【ハミング】	顔文字
ぴーあん	【ピーアン】	顔文字
おぺれった	【オペレッタ】	顔文字
ふぁんたじあ	【ファンタジア】	顔文字
ららばい	【ララバイ】	顔文字
ばらーど	【バラード】	顔文字
みんね	【ミンネ】	顔文字
めぬえっと	【メヌエット】	顔文字
まどりがる	【マドリガル】	顔文字
ぷれりゅーど	【プレリュード】	顔文字
まんぼ	【マンボ】	顔文字
おーばーど	【オーバード】	顔文字
ぱすとらる	【パストラル】	顔文字
かぷりちお	【カプリチオ】	顔文字
う゛ぃるれー	【ヴィルレー】	顔文字
まずるか	【マズルカ】	顔文字
ひむぬす	【ヒムヌス】	顔文字
ろんど	【ロンド】	顔文字
しるべんと	【シルベント】	顔文字
だーじゅ	【ダージュ】	顔文字
ぶーつ	【ブーツ】	顔文字
げーとる	【ゲートル】	顔文字
りんぐ	【リング】	顔文字
れでるせん	【レデルセン】	顔文字
れざー	【レザー】	顔文字
ろーぷ	【ローブ】	顔文字
れいぴあ	【レイピア】	顔文字
みとん	【ミトン】	顔文字
りぼん	【リボン】	顔文字
あーまー	【アーマー】	顔文字
あみゅれっと	【アミュレット】	顔文字
いやりんぐ	【イヤリング】	顔文字
えさ	【エサ】	顔文字
れぎんす	【レギンス】	顔文字
めいる	【メイル】	顔文字
おび	【帯】	顔文字
かみかざり	【髪飾り】	顔文字
けーぷ	【ケープ】	顔文字
じゅう	【銃】	顔文字
きもの	【キモノ】	顔文字
しょーとそーど	【ショートソード】	顔文字
しょきそうび	【初期装備】	顔文字
へっどばんど	【ヘッドバンド】	顔文字
じゃーきん	【ジャーキン】	顔文字
ぐろーぶ	【グローブ】	顔文字
からー	【カラー】	顔文字
きょくとう	【曲刀】	顔文字
くうぃす	【クウィス】	顔文字
すかーふ	【スカーフ】	顔文字
すぴあ	【スピア】	顔文字
ばぜらーと	【バゼラート】	顔文字
ぱた	【パタ】	顔文字
せすたす	【セスタス】	顔文字
ぷれーと	【プレート】	顔文字
あーてぃふぁくと	【アーティファクト】	顔文字
しゅぞくそうび	【種族装備】	顔文字
さりっと	【サリット】	顔文字
くれいもあ	【クレイモア】	顔文字
さぶりが	【サブリガ】	顔文字
らんす	【ランス】	顔文字
にんとう	【忍刀】	顔文字
しのびがたな	【忍刀】	顔文字
うちがたな	【打刀】	顔文字
たち	【太刀】	顔文字
ごるげっと	【ゴルゲット】	顔文字
くろーく	【クローク】	顔文字
ばすたーどそーど	【バスタードソード】	顔文字
すけいる	【スケイル】	顔文字
ふぃんがー	【フィンガー】	顔文字
とらうざ	【トラウザ】	顔文字
ちゅにっく	【チュニック】	顔文字
ちぇーん	【チェーン】	顔文字
ずぼん	【ズボン】	顔文字
だぶれっと	【ダブレット】	顔文字
はちまき	【鉢巻】	顔文字
すろっぷす	【スロップス】	顔文字
ばっくらー	【バックラー】	顔文字
がっき	【楽器】	顔文字
ろんぐそーど	【ロングソード】	顔文字
ゆみ	【弓】	顔文字
たま	【弾】	顔文字
へるむ	【ヘルム】	顔文字
や	【矢】	顔文字
くろっぐ	【クロッグ】	顔文字
はーねす	【ハーネス】	顔文字
さーくれっと	【サークレット】	顔文字
なっくる	【ナックル】	顔文字
べると	【ベルト】	顔文字
ないふ	【ナイフ】	顔文字
ぺんだんと	【ペンダント】	顔文字
ますく	【マスク】	顔文字
まんと	【マント】	顔文字
くろすぼう	【クロスボウ】	顔文字
したばき	【下ばき】	顔文字
つりざお	【釣り竿】	顔文字
へっどぎあ	【ヘッドギア】	顔文字
ぐりーう゛	【グリーヴ】	顔文字
なんでも	【何でも】	顔文字
しんし	【紳士】	顔文字
しんせつ	【親切】	顔文字
しんぼる	【シンボル】	顔文字
しんろ	【進路】	顔文字
すけじゅーる	【スケジュール】	顔文字
すてーじ	【ステージ】	顔文字
ちゅうい	【注意】	顔文字
ちゃんす	【チャンス】	顔文字
ちず	【地図】	顔文字
ばしょ	【場所】	顔文字
なかま	【仲間】	顔文字
にく	【肉】	顔文字
にっき	【日記】	顔文字
にゅーす	【ニュース】	顔文字
にんぎょう	【人形】	顔文字
ぬの	【布】	顔文字
ねこ	【ネコ】	顔文字
ねだん	【値段】	顔文字
は	【葉】	顔文字
はこ	【箱】	顔文字
はし	【橋】	顔文字
とれいん	【トレイン】	顔文字
しぜん	【自然】	顔文字
こんてすと	【コンテスト】	顔文字
こんぴゅーたー	【コンピューター】	顔文字
さいご	【最後】	顔文字
さいず	【サイズ】	顔文字
さお	【竿】	顔文字
し	【死】	顔文字
しけん	【試験】	顔文字
じこ	【事故】	顔文字
しごと	【仕事】	顔文字
じじつ	【事実】	顔文字
じんこう	【人口】	顔文字
じしん	【地震】	顔文字
しりーず	【シリーズ】	顔文字
しつ	【質】	顔文字
しつもん	【質問】	顔文字
しにあ	【シニア】	顔文字
しま	【島】	顔文字
しゃしん	【写真】	顔文字
じゆう	【自由】	顔文字
しゅうかん	【習慣】	顔文字
しゅみ	【趣味】	顔文字
ばら	【ばら】	顔文字
じしょ	【辞書】	顔文字
よろこび	【喜び】	顔文字
みす	【ミス】	顔文字
ちがい	【違い】	顔文字
ち	【血】	顔文字
だんす	【ダンス】	顔文字
みずうみ	【湖】	顔文字
みせ	【店】	顔文字
みなさん	【みなさん】	顔文字
めいれい	【命令】	顔文字
はっぴょう	【発表】	顔文字
めにゅー	【メニュー】	顔文字
ほん	【本】	顔文字
ゆめ	【夢】	顔文字
ゆうき	【勇気】	顔文字
やま	【山】	顔文字
やくそく	【約束】	顔文字
もんだい	【問題】	顔文字
ものがたり	【物語】	顔文字
もの	【物】	顔文字
もちぬし	【持ち主】	顔文字
もくてき	【目的】	顔文字
めっせーじ	【メッセージ】	顔文字
ぷろぐらむ	【プログラム】	顔文字
はな	【花】	顔文字
ことば	【言葉】	顔文字
はんぶん	【半分】	顔文字
とけい	【時計】	顔文字
ひかり	【光】	顔文字
ほほえみ	【微笑】	顔文字
びしょう	【微笑】	顔文字
ひづけ	【日付】	顔文字
ひと	【人】	顔文字
ひみつ	【ヒミツ】	顔文字
ますたー	【マスター】	顔文字
ぷれぜんと	【プレゼント】	顔文字
まーけっと	【マーケット】	顔文字
ぶんしょう	【文章】	顔文字
へいわ	【平和】	顔文字
ぼうけん	【冒険】	顔文字
ちけっと	【チケット】	顔文字
ほうこう	【方向】	顔文字
ほうこく	【報告】	顔文字
ぼうしきゃっぷ	【帽子(キャップ)】	顔文字
きゃっぷ	【帽子(キャップ)】	顔文字
ぼうしはっと	【帽子(ハット)】	顔文字
はっと	【帽子(ハット)】	顔文字
ぼーる	【ボール】	顔文字
めんきょ	【免許】	顔文字
ぶぶん	【部分】	顔文字
え	【絵】	顔文字
あるふぁべっと	【アルファベット】	顔文字
いけ	【池】	顔文字
いけん	【意見】	顔文字
いち	【位置】	顔文字
いべんと	【イベント】	顔文字
いりぐち	【入り口】	顔文字
いろ	【色】	顔文字
いわ	【岩】	顔文字
うそ	【ウソ】	顔文字
がいど	【ガイド】	顔文字
うん	【運】	顔文字
あな	【穴】	顔文字
えきさいと	【エキサイト】	顔文字
おか	【丘】	顔文字
おかね	【お金】	顔文字
おそれ	【恐れ】	顔文字
おっと	【夫】	顔文字
おと	【音】	顔文字
おとこ	【男】	顔文字
おんがく	【音楽】	顔文字
おんな	【女】	顔文字
こみゅにけーしょん	【コミュニケーション】	顔文字
うみ	【海】	顔文字
ともだち	【友達】	顔文字
どうぐ	【道具】	顔文字
でんわ	【電話】	顔文字
てすと	【テスト】	顔文字
でぐち	【出口】	顔文字
てきすと	【テキスト】	顔文字
めーる	【メール】	顔文字
てがみ	【手紙】	顔文字
て	【手】	顔文字
つま	【妻】	顔文字
つち	【土】	顔文字
あらし	【嵐】	顔文字
あめ	【雨】	顔文字
わたしのもの	【私のもの】	顔文字
れい	【例】	顔文字
りゆう	【理由】	顔文字
りすと	【リスト】	顔文字
ちょうぞう	【彫像】	顔文字
あいであ	【アイデア】	顔文字
あし	【脚】	顔文字
きゃく	【脚】	顔文字
あそび	【遊び】	顔文字
あどばいす	【アドバイス】	顔文字
かぎ	【カギ】	顔文字
つき	【月】	顔文字
げつ	【月】	顔文字
たんじょうび	【誕生日】	顔文字
かーど	【カード】	顔文字
それぞれ	【それぞれ】	顔文字
だいく	【大工】	顔文字
たてもの	【建物】	顔文字
たのしみ	【楽しみ】	顔文字
たび	【旅】	顔文字
たべもの	【食べ物】	顔文字
たまご	【たまご】	顔文字
たまねぎ	【タマネギ】	顔文字
せんせい	【先生】	顔文字
たんご	【単語】	顔文字
せんしつ	【船室】	顔文字
くつ	【くつ】	顔文字
くに	【国】	顔文字
くも	【雲】	顔文字
けいかく	【計画】	顔文字
げすと	【ゲスト】	顔文字
げんかい	【限界】	顔文字
こえ	【声】	顔文字
こおり	【氷】	顔文字
こきゅう	【呼吸】	顔文字
こたえ	【答え】	顔文字
だれか	【だれか】	顔文字
きかい	【機械】	顔文字
かぜ	【風】	顔文字
かばん	【かばん】	顔文字
かみ	【紙】	顔文字
かみ	【髪】	顔文字
かめら	【カメラ】	顔文字
かわ	【川】	顔文字
かんこう	【観光】	顔文字
そら	【空】	顔文字
きおく	【記憶】	顔文字
こども	【子供】	顔文字
きけん	【危険】	顔文字
きゃぷてん	【キャプテン】	顔文字
きゃらくたー	【キャラクター】	顔文字
きょうみ	【興味】	顔文字
くすり	【薬】	顔文字
ぜい	【税】	顔文字
せいこう	【成功】	顔文字
せいしん	【精神】	顔文字
せいふ	【政府】	顔文字
せーる	【セール】	顔文字
き	【木】	顔文字
ふぁいなる	【ファイナル】	顔文字
ふぁんたじー	【ファンタジー】	顔文字
じゅうりょく	【重力】	顔文字
ぶんかい	【分解】	顔文字
わんきょく	【湾曲】	顔文字
かくねつ	【核熱】	顔文字
しゅうしゅく	【収縮】	顔文字
ようかい	【溶解】	顔文字
こうか	【硬化】	顔文字
しんどう	【振動】	顔文字
かんつう	【貫通】	顔文字
せつだん	【切断】	顔文字
さくれつ	【炸裂】	顔文字
しょうげき	【衝撃】	顔文字
やみ	【闇】	顔文字
えびら	【箙】	顔文字
こどく	【蠱毒】	顔文字
ちょうはつ	【挑発】	顔文字
あぐれっさー	【アグレッサー】	顔文字
らすとりぞーと	【ラストリゾート】	顔文字
かまえる	【かまえる】	顔文字
ためる	【ためる】	顔文字
ちゃくら	【チャクラ】	顔文字
しーるどばっしゅ	【シールドバッシュ】	顔文字
しゅうちゅう	【集中】	顔文字
せいれいのいん	【精霊の印】	顔文字
みだれうち	【乱れ撃ち】	顔文字
とんずら	【とんずら】	顔文字
でぃふぇんだー	【ディフェンダー】	顔文字
かすめとる	【かすめとる】	顔文字
ほーりーさーくる	【ホーリーサークル】	顔文字
せんちねる	【センチネル】	顔文字
あるけいんさーくる	【アルケインサークル】	顔文字
あやつる	【あやつる】	顔文字
みやぶる	【みやぶる】	顔文字
つかいま	【使い魔】	顔文字
れんぞくま	【連続魔】	顔文字
ひゃくれつけん	【百烈拳】	顔文字
ふいうち	【不意打ち】	顔文字
まりょくのいずみ	【魔力の泉】	顔文字
なだめる	【なだめる】	顔文字
ぜったいかいひ	【絶対回避】	顔文字
ぬすむ	【ぬすむ】	顔文字
ぶらっどうぇぽん	【ブラッドウェポン】	顔文字
あんこく	【暗黒】	顔文字
そうるぼいす	【ソウルボイス】	顔文字
ばーさく	【バーサク】	顔文字
うぉーくらい	【ウォークライ】	顔文字
すかべんじ	【スカベンジ】	顔文字
かくれる	【かくれる】	顔文字
まいてぃすとらいく	【マイティストライク】	顔文字
いんびんしぶる	【インビンシブル】	顔文字
よびだす	【よびだす】	顔文字
もくそう	【黙想】	顔文字
ごまのしゅごえん	【護摩の守護円】	顔文字
めいきょうしすい	【明鏡止水】	顔文字
みじんがくれ	【微塵がくれ】	顔文字
こーるわいばーん	【コールワイバーン】	顔文字
いーぐるあい	【イーグルアイ】	顔文字
じゃんぷ	【ジャンプ】	顔文字
かげぬい	【影縫い】	顔文字
しんがん	【心眼】	顔文字
あすとらるふろう	【アストラルフロウ】	顔文字
かばう	【かばう】	顔文字
だましうち	【だまし討ち】	顔文字
いたわる	【いたわる】	顔文字
めがみのいん	【女神の印】	顔文字
えんしぇんとさーくる	【エンシェントサークル】	顔文字
かもふらーじゅ	【カモフラージュ】	顔文字
ねらいうち	【狙い撃ち】	顔文字
うぇぽんばっしゅ	【ウェポンバッシュ】	顔文字
かいひ	【回避】	顔文字
めがみのしゅくふく	【女神の祝福】	顔文字
こんばーと	【コンバート】	顔文字
きこうだん	【気孔弾】	顔文字
はいじゃんぷ	【ハイジャンプ】	顔文字
らんぱーと	【ランパート】	顔文字
すーぱーじゃんぷ	【スーパージャンプ】	顔文字
えんどれすしょっと	【エンドレスショット】	顔文字
すぴりっとりんく	【スピリットリンク】	顔文字
すーぱーくらいむ	【スーパークライム】	顔文字
りゅうけん	【竜剣】	顔文字
あじゅーるろー	【アジュールロー】	顔文字
ぶるーちぇーん	【ブルーチェーン】	顔文字
ぶるーばーすと	【ブルーバースト】	顔文字
わいるどかーど	【ワイルドカード】	顔文字
ふぁんとむろーる	【ファントムロール】	顔文字
だぶるあっぷ	【ダブルアップ】	顔文字
くいっくどろー	【クイックドロー】	顔文字
らんだむでぃーる	【ランダムディール】	顔文字
ふぁいたーずろーる	【ファイターズロール】	顔文字
もんくすろーる	【モンクスロール】	顔文字
ひーらーずろーる	【ヒーラーズロール】	顔文字
うぃざーずろーる	【ウィザーズロール】	顔文字
わーろっくすろーる	【ワーロックスロール】	顔文字
ろーぐずろーる	【ローグズロール】	顔文字
がらんつろーる	【ガランツロール】	顔文字
かおすろーる	【カオスロール】	顔文字
びーすとろーる	【ビーストロール】	顔文字
こーらるろーる	【コーラルロール】	顔文字
はんたーずろーる	【ハンターズロール】	顔文字
さむらいろーる	【サムライロール】	顔文字
にんじゃろーる	【ニンジャロール】	顔文字
どらけんろーる	【ドラケンロール】	顔文字
えぼかーずろーる	【エボカーズロール】	顔文字
めがすずろーる	【メガスズロール】	顔文字
こるせあずろーる	【コルセアズロール】	顔文字
ぱぺっとろーる	【パペットロール】	顔文字
ふぁいあしょっと	【ファイアショット】	顔文字
あいすしょっと	【アイスショット】	顔文字
うぃんどしょっと	【ウィンドショット】	顔文字
あーすしょっと	【アースショット】	顔文字
さんだーしょっと	【サンダーショット】	顔文字
うぉーたしょっと	【ウォータショット】	顔文字
らいとしょっと	【ライトショット】	顔文字
だーくしょっと	【ダークショット】	顔文字
おーばーどらいう゛	【オーバードライヴ】	顔文字
あくてぃべーと	【アクティベート】	顔文字
りぺあー	【リペアー】	顔文字
うぉりあーちゃーじ	【ウォリアーチャージ】	顔文字
とまほーく	【トマホーク】	顔文字
まんとら	【マントラ】	顔文字
むそうむねん	【無想無念】	顔文字
まーたー	【マーター】	顔文字
でう゛ぉーしょん	【デヴォーション】	顔文字
あさしんちゃーじ	【アサシンチャージ】	顔文字
ふぇいんと	【フェイント】	顔文字
ふぃーるてぃ	【フィールティ】	顔文字
しばるりー	【シバルリー】	顔文字
だーくしーる	【ダークシール】	顔文字
でぃあぼりくあい	【ディアボリクアイ】	顔文字
ふぇらるはうる	【フェラルハウル】	顔文字
けーいんすてぃんくと	【K.インスティンクト】	顔文字
きんすてぃんくと	【K.インスティンクト】	顔文字
ないちんげーる	【ナイチンゲール】	顔文字
とるばどーる	【トルバドゥール】	顔文字
すてるすしょっと	【ステルスショット】	顔文字
ふらっしーしょっと	【フラッシーショット】	顔文字
しきこうよう	【士気昂揚】	顔文字
みねうち	【峰打ち】	顔文字
でぃーぷぶりーじんぐ	【ディープブリージング】	顔文字
あんごん	【アンゴン】	顔文字
さんげ	【散華】	顔文字
さんか	【散華】	顔文字
はっそう	【八双】	顔文字
せいがん	【星眼】	顔文字
こんばーじぇんす	【コンバージェンス】	顔文字
でぃふゅーじょん	【ディフュージョン】	顔文字
すねーくあい	【スネークアイ】	顔文字
ふぉーるど	【フォールド】	顔文字
くろごちぇんじ	【黒衣チェンジ】	顔文字
こくいちぇんじ	【黒衣チェンジ】	顔文字
ふくわじゅつ	【腹話術】	顔文字
とらんす	【トランス】	顔文字
さんばもーど	【サンバモード】	顔文字
どれいんさんば	【ドレインサンバ】	顔文字
あすぴるさんば	【アスピルサンバ】	顔文字
へいすとさんば	【ヘイストサンバ】	顔文字
わるつもーど	【ワルツモード】	顔文字
けあるわるつ	【ケアルワルツ】	顔文字
ひーりんぐわるつ	【ヒーリングワルツ】	顔文字
でぃばいんわるつ	【ディバインワルツ】	顔文字
じぐもーど	【ジグモード】	顔文字
すぺくとらるじぐ	【スペクトラルジグ】	顔文字
ちょこぼじぐ	【チョコボジグ】	顔文字
すてっぷ	【ステップ】	顔文字
くいっくすてっぷ	【クイックステップ】	顔文字
ぼっくすすてっぷ	【ボックスステップ】	顔文字
すたったーすてっぷ	【スタッターステップ】	顔文字
ふらりっしゅ	【フラリッシュ】	顔文字
だぶりゅふらりっしゅ	【W.フラリッシュ】	顔文字
ｗふらりっしゅ	【W.フラリッシュ】	顔文字
でぃーふらりっしゅ	【D.フラリッシュ】	顔文字
ｄふらりっしゅ	【D.フラリッシュ】	顔文字
えーふらりっしゅ	【A.フラリッシュ】	顔文字
あふらりっしゅ	【A.フラリッシュ】	顔文字
ぶいふらりっしゅ	【V.フラリッシュ】	顔文字
ｖふらりっしゅ	【V.フラリッシュ】	顔文字
あーるふらりっしゅ	【R.フラリッシュ】	顔文字
ｒふらりっしゅ	【R.フラリッシュ】	顔文字
びーふらりっしゅ	【B.フラリッシュ】	顔文字
ｂふらりっしゅ	【B.フラリッシュ】	顔文字
れんかんけい	【連環計】	顔文字
しろのぐりもあ	【白のグリモア】	顔文字
くろのぐりもあ	【黒のグリモア】	顔文字
いいつたいろうのけい	【以逸待労の計】	顔文字
せんじゅつまどうしょ	【戦術魔道書】	顔文字
かんそせいひんのしょう	【簡素清貧の章】	顔文字
でんこうせっかのしょう	【電光石火の章】	顔文字
いきこうぜんのしょう	【意気昂然の章】	顔文字
めがみこうりんのしょう	【女神降臨の章】	顔文字
きんけんしょうしんのしょう	【勤倹小心の章】	顔文字
しっぷうじんらいのしょう	【疾風迅雷の章】	顔文字
きえんばんじょうのしょう	【気炎万丈の章】	顔文字
せいれいこうらいのしょう	【精霊光来の章】	顔文字
あかんぷりす	【アカンプリス】	顔文字
べろしてぃしょっと	【ベロシティショット】	顔文字
えれめんとさいふぉん	【エレメントサイフォン】	顔文字
だんさーろーる	【ダンサーロール】	顔文字
すからーろーる	【スカラーロール】	顔文字
きじょうえんしゅう	【机上演習】	顔文字
しろのほい	【白の補遺】	顔文字
くろのほい	【黒の補遺】	顔文字
せっかのき	【石火之機】	顔文字
りたりえーしょん	【リタリエーション】	顔文字
こらぼれーたー	【コラボレーター】	顔文字
ねこあしだち	【猫足立ち】	顔文字
ぴあにっしも	【ピアニッシモ】	顔文字
つるぎのまい	【剣の舞い】	顔文字
おうぎのまい	【扇の舞い】	顔文字
のーふっとらいず	【ノーフットライズ】	顔文字
ふしゃくしんみょうのしょう	【不惜身命の章】	顔文字
いっしんせいしんのしょう	【一心精進の章】	顔文字
いっしんしょうじんのしょう	【一心精進の章】	顔文字
てんいむほうのしょう	【天衣無縫の章】	顔文字
むゆうむふうのしょう	【無憂無風の章】	顔文字
たいごてってい	【大悟徹底】	顔文字
はーとおぶそらす	【ハートオブソラス】	顔文字
はーとおぶみぜり	【ハートオブミゼリ】	顔文字
こんぽーじゃー	【コンポージャー】	顔文字
ようにん	【陽忍】	顔文字
いんにん	【陰忍】	顔文字
れじすとばいんど	【レジストバインド】	顔文字
れじすとぺとり	【レジストペトリ】	顔文字
とりぷるあたっく	【トリプルアタック】	顔文字
ぷらんといどきらー	【プラントイドキラー】	顔文字
れじすとすろう	【レジストスロウ】	顔文字
すとあてぃーぴー	【ストアTP】	顔文字
すとあｔｐ	【ストアTP】	顔文字
すてるす	【ステルス】	顔文字
にとうりゅう	【二刀流】	顔文字
えむぴーまっくすあっぷ	【MPmaxアップ】	顔文字
ｍｐまっくすあっぷ	【MPmaxアップ】	顔文字
おーとりふれしゅ	【オートリフレシュ】	顔文字
どらごんきらー	【ドラゴンキラー】	顔文字
う゛ぁーみんきらー	【ヴァーミンキラー】	顔文字
でーもんきらー	【デーモンキラー】	顔文字
まほうぼうぎょりょくあっぷ	【魔法防御力アップ】	顔文字
とれじゃーはんたー	【トレジャーハンター】	顔文字
かうんたー	【カウンター】	顔文字
だぶるあたっく	【ダブルアタック】	顔文字
こんさーぶえむぴー	【コンサーブMP】	顔文字
こんさーぶｍｐ	【コンサーブMP】	顔文字
ふぁすときゃすと	【ファストキャスト】	顔文字
らぴっどしょっと	【ラピッドショット】	顔文字
れじすとぐらびてぃ	【レジストグラビティ】	顔文字
えいちぴーまっくすあっぷ	【HPmaxアップ】	顔文字
ｈｐまっくすあっぷ	【HPmaxアップ】	顔文字
けいかい	【警戒】	顔文字
まほうこうげきりょくあっぷ	【魔法攻撃力アップ】	顔文字
ぶつりぼうぎょりょくあっぷ	【物理防御力アップ】	顔文字
ぶつりこうげきりょくあっぷ	【物理攻撃力アップ】	顔文字
ぶつりかいひりつあっぷ	【物理回避率アップ】	顔文字
ぶつりめいちゅうりつあっぷ	【物理命中率アップ】	顔文字
しゅうげき	【蹴撃】	顔文字
おーとりじぇね	【オートリジェネ】	顔文字
あくあんきらー	【アクアンキラー】	顔文字
れじすとちゃーむ	【レジストチャーム】	顔文字
れじすとうぃるす	【レジストウィルス】	顔文字
れじすとさいれす	【レジストサイレス】	顔文字
れじすとぱらいず	【レジストパライズ】	顔文字
れじすとぽいずん	【レジストポイズン】	顔文字
れじすとすりーぷ	【レジストスリープ】	顔文字
あんでっどきらー	【アンデッドキラー】	顔文字
ぎるすてぃーる	【ギルスティール】	顔文字
あもるふきらー	【アモルフキラー】	顔文字
ばーどきらー	【バードキラー】	顔文字
りざーどきらー	【リザードキラー】	顔文字
くりあまいんど	【クリアマインド】	顔文字
まーしゃるあーつ	【マーシャルアーツ】	顔文字
あるかなきらー	【アルカナキラー】	顔文字
びーすときらー	【ビーストキラー】	顔文字
れじすとぶらいん	【レジストブライン】	顔文字
れじすとかーず	【レジストカーズ】	顔文字
れじすとすたん	【レジストスタン】	顔文字
もくしゃ	【モクシャ】	顔文字
あさしん	【アサシン】	顔文字
めがみのじひ	【女神の慈悲】	顔文字
ざんしん	【残心】	顔文字
しーるどますたりー	【シールドマスタリー】	顔文字
さべっじり	【サベッジリ】	顔文字
あぐれしぶえいむ	【アグレシブエイム】	顔文字
れんき	【練気】	顔文字
はっけい	【発剄】	顔文字
おーらすてぃーる	【オーラスティール】	顔文字
あんぶっしゅ	【アンブッシュ】	顔文字
あいあんうぃる	【アイアンウィル】	顔文字
がーでぃあん	【ガーディアン】	顔文字
みゅーてっどそうる	【ミューテッドソウル】	顔文字
ですぺれーとぶろー	【デスペレートブロー】	顔文字
びーすとあふにてぃ	【ビーストアフニティ】	顔文字
びーすとひーらー	【ビーストヒーラー】	顔文字
すなっぷしょっと	【スナップショット】	顔文字
りさいくる	【リサイクル】	顔文字
いきしょうてん	【意気衝天】	顔文字
せいせいどうどう	【正正堂堂】	顔文字
にんぐのちしき	【忍具の知識】	顔文字
えんぱしー	【エンパシー】	顔文字
すとれいふ	【ストレイフ】	顔文字
えんちぇーんめんと	【エンチェーンメント】	顔文字
あしみれーしょん	【アシミレーション】	顔文字
うぃにんぐすとりーく	【ウィニングストリーク】	顔文字
ろーでっどでっき	【ローデッドデッキ】	顔文字
びちょうせい	【微調整】	顔文字
さいてきか	【最適化】	顔文字
しーぽじしょん	【Ｃ・ポジション】	顔文字
ｃぽじしょん	【Ｃ・ポジション】	顔文字
じんとうしき	【陣頭指揮】	顔文字
すらっぐしょっと	【スラッグショット】	顔文字
たっくる	【タックル】	顔文字
れっどろーたす	【レッドロータス】	顔文字
すぴりっつうぃずいん	【スピリッツウィズイン】	顔文字
ばっくはんどぶろー	【バックハンドブロー】	顔文字
ぱわーすらっしゅ	【パワースラッシュ】	顔文字
ふぁすとぶれーど	【ファストブレード】	顔文字
ふらっとぶれーど	【フラットブレード】	顔文字
ふりーずばいと	【フリーズバイト】	顔文字
ぶれいんしぇいかー	【ブレインシェイカー】	顔文字
ふろすとばいと	【フロストバイト】	顔文字
へう゛ぃすいんぐ	【ヘヴィスイング】	顔文字
らいでんすらすと	【ライデンスラスト】	顔文字
ばーにんぐぶれーど	【バーニングブレード】	顔文字
れいじんぐあくす	【レイジングアクス】	顔文字
はーどすらっしゅ	【ハードスラッシュ】	顔文字
ろっくくらっしゃー	【ロッククラッシャー】	顔文字
わすぷすてぃんぐ	【ワスプスティング】	顔文字
らんげき	【乱撃】	顔文字
すぴんあたっく	【スピンアタック】	顔文字
たんけい	【短勁】	顔文字
さいくろん	【サイクロン】	顔文字
すないぱーしょっと	【スナイパーショット】	顔文字
えなじーどれいん	【エナジードレイン】	顔文字
だんしんぐえっじ	【ダンシングエッジ】	顔文字
せらふぶれーど	【セラフブレード】	顔文字
さーくるぶれーど	【サークルブレード】	顔文字
らふぁーるあくす	【ラファールアクス】	顔文字
しゃいんぶれーど	【シャインブレード】	顔文字
あーすくらっしゃー	【アースクラッシャー】	顔文字
あーまーぶれいく	【アーマーブレイク】	顔文字
あいあんてんぺすと	【アイアンテンペスト】	顔文字
あしばらい	【足払い】	顔文字
あばらんちあくす	【アバランチアクス】	顔文字
がすとすらっしゅ	【ガストスラッシュ】	顔文字
こんぼ	【コンボ】	顔文字
さんだーすらすと	【サンダースラスト】	顔文字
ばいぱーばいと	【バイパーバイト】	顔文字
しゃいんすとらいく	【シャインストライク】	顔文字
えなじーすてぃーる	【エナジースティール】	顔文字
しゃどーおぶです	【シャドーオブデス】	顔文字
しゃどーすてっち	【シャドーステッチ】	顔文字
しゅとるむう゛ぃんと	【シュトルムヴィント】	顔文字
すたーばーすと	【スターバースト】	顔文字
すたーらいと	【スターライト】	顔文字
すまっしゅ	【スマッシュ】	顔文字
すらいす	【スライス】	顔文字
せらふすとらいく	【セラフストライク】	顔文字
だーくはーべすと	【ダークハーベスト】	顔文字
だぶるすらすと	【ダブルスラスト】	顔文字
ないとめあさいす	【ナイトメアサイス】	顔文字
しーるどぶれいく	【シールドブレイク】	顔文字
じゃっじめんと	【ジャッジメント】	顔文字
じん	【迅】	顔文字
ぼーぱるぶれーど	【ボーパルブレード】	顔文字
にのたちほうばく	【弐之太刀・鋒縛】	顔文字
ほうばく	【弐之太刀・鋒縛】	顔文字
くうめいけん	【空鳴拳】	顔文字
よんのたちかげろう	【四之太刀・陽炎】	顔文字
かげろう	【四之太刀・陽炎】	顔文字
ごのたちじんぷう	【五之太刀・陣風】	顔文字
じんぷう	【五之太刀・陣風】	顔文字
ろくのたちこうき	【六之太刀・光輝】	顔文字
こうき	【六之太刀・光輝】	顔文字
ななのたちせっぷう	【七之太刀・雪風】	顔文字
ななのたちゆきかぜ	【七之太刀・雪風】	顔文字
せっぷう	【七之太刀・雪風】	顔文字
ゆきかぜ	【七之太刀・雪風】	顔文字
むーんらいと	【ムーンライト】	顔文字
えい	【影】	顔文字
とぅるーすとらいく	【トゥルーストライク】	顔文字
いちのたちえんぴ	【壱之太刀・燕飛】	顔文字
えんぴ	【壱之太刀・燕飛】	顔文字
さんばーすと	【サンバースト】	顔文字
しぇるくらっしゃー	【シェルクラッシャー】	顔文字
ふるすいんぐ	【フルスイング】	顔文字
ふれいみんぐあろー	【フレイミングアロー】	顔文字
ぴあしんぐあろー	【ピアシングアロー】	顔文字
だりんぐあろー	【ダリングアロー】	顔文字
さいどわいんだー	【サイドワインダー】	顔文字
ほっとしょっと	【ホットショット】	顔文字
すぷりっとしょっと	【スプリットショット】	顔文字
すかるぶれいかー	【スカルブレイカー】	顔文字
うぇぽんぶれいく	【ウェポンブレイク】	顔文字
しょっくうぇーぶ	【ショックウェーブ】	顔文字
くれせんとむーん	【クレセントムーン】	顔文字
しっくるむーん	【シックルムーン】	顔文字
すぴにんぐあくす	【スピニングアクス】	顔文字
らんぺーじ	【ランページ】	顔文字
さんのたちごうてん	【参之太刀・轟天】	顔文字
ごうてん	【参之太刀・轟天】	顔文字
きーんえっじ	【キーンエッジ】	顔文字
れいじんぐらっしゅ	【レイジングラッシュ】	顔文字
すぴにんぐさいす	【スピニングサイス】	顔文字
ぼーぱるさいす	【ボーパルサイス】	顔文字
ぎろてぃん	【ギロティン】	顔文字
ぺんたすらすと	【ペンタスラスト】	顔文字
ぼーぱるすらすと	【ボーパルスラスト】	顔文字
りん	【臨】	顔文字
れつ	【烈】	顔文字
てき	【滴】	顔文字
とう	【凍】	顔文字
ち	【地】	顔文字
からみてぃ	【カラミティ】	顔文字
すきゅあー	【スキュアー】	顔文字
あーちんぐあろー	【アーチングアロー】	顔文字
くろすりーぱー	【クロスリーパー】	顔文字
てん	【天】	顔文字
ぶらすとあろー	【ブラストアロー】	顔文字
ぶらすとしょっと	【ブラストショット】	顔文字
そうりゅうきゃく	【双竜脚】	顔文字
ふるぶれいく	【フルブレイク】	顔文字
へう゛ぃしょっと	【ヘヴィショット】	顔文字
へきさすとらいく	【ヘキサストライク】	顔文字
すぴりっとてーかー	【スピリットテーカー】	顔文字
すうぃふとぶれーど	【スウィフトブレード】	顔文字
はちのたちげっこう	【八之太刀・月光】	顔文字
げっこう	【八之太刀・月光】	顔文字
だいしゃりん	【大車輪】	顔文字
しゃーくばいと	【シャークバイト】	顔文字
すぴんすらっしゅ	【スピンスラッシュ】	顔文字
みすとらるあくす	【ミストラルアクス】	顔文字
さべっじぶれーど	【サベッジブレード】	顔文字
むそうあしゅらけん	【夢想阿修羅拳】	顔文字
えう゛ぃされーしょん	【エヴィサレーション】	顔文字
でしめーしょん	【デシメーション】	顔文字
すぱいらるへる	【スパイラルヘル】	顔文字
ぶらっくへいろー	【ブラックヘイロー】	顔文字
すちーるさいくろん	【スチールサイクロン】	顔文字
ぐらうんどすとらいく	【グラウンドストライク】	顔文字
いんぱるすどらいう゛	【インパルスドライヴ】	顔文字
れとりびゅーしょん	【レトリビューション】	顔文字
くう	【空】	顔文字
きゅうのたちかしゃ	【九之太刀・花車】	顔文字
くのたちかしゃ	【九之太刀・花車】	顔文字
かしゃ	【九之太刀・花車】	顔文字
えんぴりあるあろー	【エンピリアルアロー】	顔文字
きんぐずじゃすてぃす	【キングズジャスティス】	顔文字
あすけーてんつぉるん	【アスケーテンツォルン】	顔文字
みすてぃっくぶーん	【ミスティックブーン】	顔文字
う゛ぃぞふにる	【ヴィゾフニル】	顔文字
ろずれーふぁたーる	【ロズレーファタール】	顔文字
まんだりくすたっぶ	【マンダリクスタッブ】	顔文字
ろいえ	【ロイエ】	顔文字
いんさーじぇんしー	【インサージェンシー】	顔文字
ぷらいまるれんど	【プライマルレンド】	顔文字
もーだんとらいむ	【モーダントライム】	顔文字
とぅるーふらいと	【トゥルーフライト】	顔文字
じゅうのたちらんあ	【十之太刀・乱鴉】	顔文字
とおのたちらんあ	【十之太刀・乱鴉】	顔文字
らんあ	【十之太刀・乱鴉】	顔文字
かむはぶり	【カムハブリ】	顔文字
うんじょうりゅうへん	【雲蒸竜変】	顔文字
うんじょうりょうへん	【雲蒸竜変】	顔文字
がーらんどおぶぶりす	【ガーランドオブブリス】	顔文字
えくすぴあしおん	【エクスピアシオン】	顔文字
れでんさりゅーと	【レデンサリュート】	顔文字
れんかんろくごうけん	【連環六合圏】	顔文字
れんかんりくごうけん	【連環六合圏】	顔文字
ぴりっくくれおす	【ピリッククレオス】	顔文字
おむにしえんす	【オムニシエンス】	顔文字
でとねーたー	【デトネーター】	顔文字
じゅばくのじゅつ	【呪縛の術】	顔文字
とんこうのじゅつ	【遁甲の術】	顔文字
かとんのじゅつ	【火遁の術】	顔文字
どとんのじゅつ	【土遁の術】	顔文字
ふうとんのじゅつ	【風遁の術】	顔文字
すいとんのじゅつ	【水遁の術】	顔文字
ひょうとんのじゅつ	【氷遁の術】	顔文字
うつせみのじゅつ	【空蝉の術】	顔文字
くらやみのじゅつ	【暗闇の術】	顔文字
ほじょうのじゅつ	【捕縄の術】	顔文字
どくもりのじゅつ	【毒盛の術】	顔文字
らいとんのじゅつ	【雷遁の術】	顔文字
ものみのじゅつ	【物見の術】	顔文字
かーばんくる	【カーバンクル】	顔文字
いふりーと	【イフリート】	顔文字
たいたん	【タイタン】	顔文字
りう゛ぁいあさん	【リヴァイアサン】	顔文字
しう゛ぁ	【シヴァ】	顔文字
がるーだ	【ガルーダ】	顔文字
らむう	【ラムウ】	顔文字
ふぇんりる	【フェンリル】	顔文字
でぃあぼろす	【ディアボロス】	顔文字
たたかえ	【たたかえ】	顔文字
もどれ	【もどれ】	顔文字
かえれ	【かえれ】	顔文字
ほんきだせ	【ほんきだせ】	顔文字
まってろ	【まってろ】	顔文字
しんじゅうのこうげき	【神獣の攻撃】	顔文字
しんじゅうのたいひ	【神獣の退避】	顔文字
しんじゅうのきかん	【神獣の帰還】	顔文字
けいやくのりこうげんじゅつ	【契約の履行:幻術】	顔文字
りこうげんじゅつ	【契約の履行:幻術】	顔文字
げんじゅつ	【契約の履行:幻術】	顔文字
りこう	【契約の履行:幻術】	顔文字
しんくうのよろい	【真空の鎧】	顔文字
あくすきっく	【アクスキック】	顔文字
ばらくーだだいぶ	【バラクーダダイブ】	顔文字
ばーにんぐすとらいく	【バーニングストライク】	顔文字
かおすすとらいく	【カオスストライク】	顔文字
くろー	【クロー】	顔文字
ぐれんのほうこう	【紅蓮の咆哮】	顔文字
だぶるぱんち	【ダブルパンチ】	顔文字
だぶるすらっぷ	【ダブルスラップ】	顔文字
だいちのまもり	【大地の守り】	顔文字
ふれいむくらっしゅ	【フレイムクラッシュ】	顔文字
いてつくよろい	【凍てつく鎧】	顔文字
るびーのきらめき	【ルビーの煌き】	顔文字
るびーのいやし	【ルビーの癒し】	顔文字
へいすが	【ヘイスガ】	顔文字
らいでんのよろい	【雷電の鎧】	顔文字
めがりすすろー	【メガリススロー】	顔文字
ぷちめてお	【プチメテオ】	顔文字
まうんてんばすたー	【マウンテンバスター】	顔文字
ぽいずんねいる	【ポイズンネイル】	顔文字
ぷれでたーくろー	【プレデタークロー】	顔文字
ぱんち	【パンチ】	顔文字
ろっくばすたー	【ロックバスター】	顔文字
ろっくすろー	【ロックスロー】	顔文字
らいこ	【雷鼓】	顔文字
らっしゅ	【ラッシュ】	顔文字
るびーのかがやき	【ルビーの輝き】	顔文字
しょっくすとらいく	【ショックストライク】	顔文字
すりぷが	【スリプガ】	顔文字
すろうが	【スロウガ】	顔文字
すぴにんぐだいぶ	【スピニングダイブ】	顔文字
ゆうすい	【湧水】	顔文字
てーるうぃっぷ	【テールウィップ】	顔文字
さんだーすぱーく	【サンダースパーク】	顔文字
かぜのささやき	【風の囁き】	顔文字
しありんぐらいと	【シアリングライト】	顔文字
いんふぇるの	【インフェルノ】	顔文字
あーすふゅーりー	【アースフューリー】	顔文字
たいだるうぇいぶ	【タイダルウェイブ】	顔文字
えりあるぶらすと	【エリアルブラスト】	顔文字
だいやもんどだすと	【ダイヤモンドダスト】	顔文字
じゃっじぼると	【ジャッジボルト】	顔文字
そうかん	【送還】	顔文字
むーんりっとちゃーじ	【ムーンリットチャージ】	顔文字
くれせんとふぁんぐ	【クレセントファング】	顔文字
るなーくらい	【ルナークライ】	顔文字
るなーろあ	【ルナーロア】	顔文字
じょうげんのうなり	【上弦の唸り】	顔文字
かげんのほうこう	【下弦の咆哮】	顔文字
えくりぷすばいと	【エクリプスバイト】	顔文字
はうりんぐむーん	【ハウリングムーン】	顔文字
かみさどー	【カミサドー】	顔文字
そむのれんす	【ソムノレンス】	顔文字
ないとめあ	【ナイトメア】	顔文字
あるてぃめっとてらー	【アルティメットテラー】	顔文字
のくとしーるど	【ノクトシールド】	顔文字
どりーむしゅらうど	【ドリームシュラウド】	顔文字
ねざーぶらすと	【ネザーブラスト】	顔文字
るいなすおーめん	【ルイナスオーメン】	顔文字
でぃあくてぃべーと	【ディアクティベート】	顔文字
でぃぷろい	【ディプロイ】	顔文字
りとりーぶ	【リトリーブ】	顔文字
ふぁいあまにゅーば	【ファイアマニューバ】	顔文字
あいすまにゅーば	【アイスマニューバ】	顔文字
うぃんどまにゅーば	【ウィンドマニューバ】	顔文字
あーすまにゅーば	【アースマニューバ】	顔文字
さんだーまにゅーば	【サンダーマニューバ】	顔文字
うぉーたまにゅーば	【ウォータマニューバ】	顔文字
らいとまにゅーば	【ライトマニューバ】	顔文字
だーくまにゅーば	【ダークマニューバ】	顔文字
めておすとらいく	【メテオストライク】	顔文字
じおくらっしゅ	【ジオクラッシュ】	顔文字
ぐらんどふぉーる	【グランドフォール】	顔文字
ういんどぶれーど	【ウインドブレード】	顔文字
へう゛んりーすとらいく	【ヘヴンリーストライク】	顔文字
さんだーすとーむ	【サンダーストーム】	顔文字
けいやくのりこうけんじゅつ	【契約の履行:験術】	顔文字
りこうけんじゅつ	【契約の履行:験術】	顔文字
けんじゅつ	【契約の履行:験術】	顔文字
りこう	【契約の履行:験術】	顔文字
ひきつけろ	【ひきつけろ】	顔文字
めいんうぇぽん	【メインウェポン】	顔文字
さぶうぇぽん	【サブウェポン】	顔文字
れんじうぇぽん	【レンジウェポン】	顔文字
やだん	【矢弾】	顔文字
あたま	【頭】	顔文字
くび	【首】	顔文字
ひだりみみ	【左耳】	顔文字
みぎみみ	【右耳】	顔文字
どう	【胴】	顔文字
りょうて	【両手】	顔文字
ひだりてのゆび	【左手の指】	顔文字
みぎてのゆび	【右手の指】	顔文字
せ	【背】	顔文字
こし	【腰】	顔文字
りょうきゃく	【両脚】	顔文字
りょうあし	【両脚】	顔文字
りょうそく	【両足】	顔文字
りょうあし	【両足】	顔文字
べのむしぇる	【ベノムシェル】	顔文字
めいるしゅとろむ	【メイルシュトロム】	顔文字
めたるぼでぃ	【メタルボディ】	顔文字
えすどらいばー	【S.ドライバー】	顔文字
ｓどらいばー	【S.ドライバー】	顔文字
えむぴーきゅうしゅうきっす	【MP吸収キッス】	顔文字
ｍｐきゅうしゅうきっす	【MP吸収キッス】	顔文字
ですれい	【デスレイ】	顔文字
つちたつまき	【土竜巻】	顔文字
いかりのいちげき	【怒りの一撃】	顔文字
めったうち	【メッタ打ち】	顔文字
りふゅえりんぐ	【リフュエリング】	顔文字
あいすぶれいく	【アイスブレイク】	顔文字
びーしゅとらーる	【B.シュトラール】	顔文字
ｂしゅとらーる	【B.シュトラール】	顔文字
じばく	【自爆】	顔文字
しんぴのひかり	【神秘の光】	顔文字
こーるどうぇーぶ	【コールドウェーブ】	顔文字
ぽいずんぶれす	【ポイズンブレス】	顔文字
すてぃんきんぐがす	【スティンキングガス】	顔文字
めめんともーり	【メメントモーリ】	顔文字
てらーたっち	【テラータッチ】	顔文字
すぱいなるくりーぶ	【スパイナルクリーブ】	顔文字
ぶらっどせいばー	【ブラッドセイバー】	顔文字
しょうか	【消化】	顔文字
えむばいと	【M.バイト】	顔文字
ｍばいと	【M.バイト】	顔文字
かーすどすふぃあ	【カースドスフィア】	顔文字
しっくるすらっしゅ	【シックルスラッシュ】	顔文字
こくーん	【コクーン】	顔文字
えふほーるど	【F.ホールド】	顔文字
ｆほーるど	【F.ホールド】	顔文字
かふん	【花粉】	顔文字
ぱわーあたっく	【パワーアタック】	顔文字
ですしざーす	【デスシザース】	顔文字
じてっぷん	【磁鉄粉】	顔文字
あいずおんみー	【アイズオンミー】	顔文字
えふりっぷ	【F.リップ】	顔文字
ｆりっぷ	【F.リップ】	顔文字
ふらいとふるろあ	【フライトフルロア】	顔文字
へかとんうぇーぶ	【ヘカトンウェーブ】	顔文字
ぼでぃぷれす	【ボディプレス】	顔文字
あーるぶれす	【R.ブレス】	顔文字
ｒぶれす	【R.ブレス】	顔文字
へるだいぶ	【ヘルダイブ】	顔文字
じぇっとすとりーむ	【ジェットストリーム】	顔文字
きゅうけつ	【吸血】	顔文字
さうんどぶらすと	【サウンドブラスト】	顔文字
ふぇざーてぃっくる	【フェザーティックル】	顔文字
ふぇざーばりあ	【フェザーバリア】	顔文字
じぇたちゅら	【ジェタチュラ】	顔文字
やーん	【ヤーン】	顔文字
ふっときっく	【フットキック】	顔文字
きゅういん	【吸印】	顔文字
いやしのかぜ	【いやしの風】	顔文字
かおてぃっくあい	【カオティックアイ】	顔文字
しーぷそんぐ	【シープソング】	顔文字
らむちゃーじ	【ラムチャージ】	顔文字
くろーさいくろん	【クローサイクロン】	顔文字
ろういん	【ロウイン】	顔文字
じげんさつ	【次元殺】	顔文字
かえんのいき	【火炎の息】	顔文字
まじっくふるーつ	【マジックフルーツ】	顔文字
あっぱーかっと	【アッパーカット】	顔文字
はりせんぼん	【針千本】	顔文字
まつぼっくりばくだん	【まつぼっくり爆弾】	顔文字
すぷらうとすまっく	【スプラウトスマック】	顔文字
さぺりふぃっく	【サペリフィック】	顔文字
まよいたけ	【マヨイタケ】	顔文字
たねまき	【種まき】	顔文字
くさいいき	【臭い息】	顔文字
がいすとうぉーる	【ガイストウォール】	顔文字
あーふるあい	【アーフルアイ】	顔文字
ふろすとぶれす	【フロストブレス】	顔文字
ちょうていしゅうは	【超低周波】	顔文字
でぃせばーめんと	【ディセバーメント】	顔文字
えーばーすと	【A.バースト】	顔文字
あばーすと	【A.バースト】	顔文字
はんのうろれいきゃく	【反応炉冷却】	顔文字
せいりーんこーと	【セイリーンコート】	顔文字
ぷらずまちゃーじ	【プラズマチャージ】	顔文字
てんぽらるしふと	【テンポラルシフト】	顔文字
ばーちかるくりーう゛	【バーチカルクリーヴ】	顔文字
さくれつだん	【炸裂弾】	顔文字
ばとるだんす	【バトルダンス】	顔文字
さんどすぷれー	【サンドスプレー】	顔文字
ぐらんどすらむ	【グランドスラム】	顔文字
へっどばっと	【ヘッドバット】	顔文字
ばくだんなげ	【爆弾投げ】	顔文字
ふらいぱん	【フライパン】	顔文字
えふひっぷぷれす	【F.ヒッププレス】	顔文字
ｆひっぷぷれす	【F.ヒッププレス】	顔文字
はいどろしょっと	【ハイドロショット】	顔文字
こんごうしん	【金剛身】	顔文字
とっかん	【吶喊】	顔文字
しょくざいのひかり	【贖罪の光】	顔文字
わーむあっぷ	【ワームアップ】	顔文字
ふぁいあーすぴっと	【ファイアースピット】	顔文字
はねふぶき	【羽根吹雪】	顔文字
てーるすらっぷ	【テールスラップ】	顔文字
えいちばらーじ	【H.バラージ】	顔文字
ｈばらーじ	【H.バラージ】	顔文字
ねたみぐさ	【ねたみ種】	顔文字
きゃのんぼーる	【キャノンボール】	顔文字
わいるどかろっと	【ワイルドカロット】	顔文字
ぶらんくげいず	【ブランクゲイズ】	顔文字
まいんどぶらすと	【マインドブラスト】	顔文字
いぐじゅびえーしょん	【イグジュビエーション】	顔文字
まじっくはんまー	【マジックハンマー】	顔文字
ぜふぁーまんと	【ゼファーマント】	顔文字
りがーじてーしょん	【リガージテーション】	顔文字
しーどすぷれー	【シードスプレー】	顔文字
ころーしぶうーず	【コローシブウーズ】	顔文字
すぱいらるすぴん	【スパイラルスピン】	顔文字
あしゅらくろー	【アシュラクロー】	顔文字
さぶぜろすまっしゅ	【サブゼロスマッシュ】	顔文字
きょうめい	【共鳴】	顔文字
ろすう゛ぁいせのま	【ロスヴァイセの間】	顔文字
ぐりむげるでのま	【グリムゲルデの間】	顔文字
じーくるーねのま	【ジークルーネの間】	顔文字
へるむう゛ぃーげのま	【ヘルムヴィーゲの間】	顔文字
しゅう゛ぇるとらいてのま	【シュヴェルトライテの間】	顔文字
う゛ぁるとらうてのま	【ヴァルトラウテの間】	顔文字
おるとりんでのま	【オルトリンデの間】	顔文字
げるひるでのま	【ゲルヒルデの間】	顔文字
ぶりゅんひるでのま	【ブリュンヒルデの間】	顔文字
おーでぃんのま	【オーディンの間】	顔文字
ちょこぼさーきっと	【チョコボサーキット】	顔文字
ころせうむ	【コロセウム】	顔文字
みなみさんどりあえす	【南サンドリア〔Ｓ〕】	顔文字
みなみさんどりあｓ	【南サンドリア〔Ｓ〕】	顔文字
ひがしろんふぉーるえす	【東ロンフォール〔Ｓ〕】	顔文字
ひがしろんふぉーるｓ	【東ロンフォール〔Ｓ〕】	顔文字
じゃぐなーしんりんえす	【ジャグナー森林〔Ｓ〕】	顔文字
じゃぐなーしんりんｓ	【ジャグナー森林〔Ｓ〕】	顔文字
ばたりあきゅうりょうえす	【バタリア丘陵〔Ｓ〕】	顔文字
ばたりあきゅうりょうｓ	【バタリア丘陵〔Ｓ〕】	顔文字
とこはなのせっくつ	【常花の石窟】	顔文字
えるでぃーむこふんえす	【エルディーム古墳〔Ｓ〕】	顔文字
えるでぃーむこふんｓ	【エルディーム古墳〔Ｓ〕】	顔文字
ばすとぅーくしょうぎょうくえす	【バストゥーク商業区〔Ｓ〕】	顔文字
ばすとぅーくしょうぎょうくｓ	【バストゥーク商業区〔Ｓ〕】	顔文字
きたぐすたべるぐえす	【北グスタベルグ〔Ｓ〕】	顔文字
きたぐすたべるぐｓ	【北グスタベルグ〔Ｓ〕】	顔文字
ぐろうべるぐえす	【グロウベルグ〔Ｓ〕】	顔文字
ぐろうべるぐｓ	【グロウベルグ〔Ｓ〕】	顔文字
るほっつぎんざん	【ルホッツ銀山】	顔文字
ぶんかーるうらえす	【ブンカール浦〔Ｓ〕】	顔文字
ぶんかーるうらｓ	【ブンカール浦〔Ｓ〕】	顔文字
ぱしゅはうぬまえす	【パシュハウ沼〔Ｓ〕】	顔文字
ぱしゅあうぬまｓ	【パシュハウ沼〔Ｓ〕】	顔文字
ろらんべりーこうちえす	【ロランベリー耕地〔Ｓ〕】	顔文字
ろらんべりーこうちｓ	【ロランベリー耕地〔Ｓ〕】	顔文字
くろうらーのすえす	【クロウラーの巣〔Ｓ〕】	顔文字
くろうらーのすｓ	【クロウラーの巣〔Ｓ〕】	顔文字
うぃんだすみずのくえす	【ウィンダス水の区〔Ｓ〕】	顔文字
うぃんだすみずのくｓ	【ウィンダス水の区〔Ｓ〕】	顔文字
にしさるたばるたえす	【西サルタバルタ〔Ｓ〕】	顔文字
にしさるたばるたｓ	【西サルタバルタ〔Ｓ〕】	顔文字
かるごなるごじょうさいえす	【カルゴナルゴ城砦〔Ｓ〕】	顔文字
かるごなるごじょうさいｓ	【カルゴナルゴ城砦〔Ｓ〕】	顔文字
ごゆのくうどう	【ゴユの空洞】	顔文字
めりふぁとさんちえす	【メリファト山地〔Ｓ〕】	顔文字
めりふぁとさんちｓ	【メリファト山地〔Ｓ〕】	顔文字
そろむぐげんやえす	【ソロムグ原野〔Ｓ〕】	顔文字
そろむぐげんやｓ	【ソロムグ原野〔Ｓ〕】	顔文字
がるれーじゅようさいえす	【ガルレージュ要塞〔Ｓ〕】	顔文字
がるれーじゅようさいｓ	【ガルレージュ要塞〔Ｓ〕】	顔文字
ろんふぉーるせんせん	【ロンフォール戦線】	顔文字
のるばれんせんせん	【ノルバレン戦線】	顔文字
ぐすたべるぐせんせん	【グスタベルグ戦線】	顔文字
でるふらんとせんせん	【デルフラント戦線】	顔文字
さるたばるたせんせん	【サルタバルタ戦線】	顔文字
あらごーにゅせんせん	【アラゴーニュ戦線】	顔文字
らう゛ぉーるむらえす	【ラヴォール村〔Ｓ〕】	顔文字
らう゛ぉーるむらｓ	【ラヴォール村〔Ｓ〕】	顔文字
べどーえす	【ベドー〔Ｓ〕】	顔文字
べどーｓ	【ベドー〔Ｓ〕】	顔文字
おずとろやじょうえす	【オズトロヤ城〔Ｓ〕】	顔文字
おずとろやじょうｓ	【オズトロヤ城〔Ｓ〕】	顔文字
ぼすでぃんひょうがえす	【ボスディン氷河〔Ｓ〕】	顔文字
ぼすでぃんひょうがｓ	【ボスディン氷河〔Ｓ〕】	顔文字
ざるかばーどえす	【ザルカバード〔Ｓ〕】	顔文字
ざるかばーどｓ	【ザルカバード〔Ｓ〕】	顔文字
ふぉるがんでぃせんせん	【フォルガンディ戦線】	顔文字
ばるどにあせんせん	【バルドニア戦線】	顔文字
あびせあらてーぬ	【アビセア-ラテーヌ】	顔文字
あびせあこんしゅたっと	【アビセア-コンシュタット】	顔文字
あびせあたろんぎ	【アビセア-タロンギ】	顔文字
あびせあぶんかーる	【アビセア-ブンカール】	顔文字
あびせあみざれお	【アビセア-ミザレオ】	顔文字
あびせああっとわ	【アビセア-アットワ】	顔文字
あびせあぐろうべるぐ	【アビセア-グロウベルグ】	顔文字
あびせあうるがらん	【アビセア-ウルガラン】	顔文字
あびせああるてぱ	【アビセア-アルテパ】	顔文字
あびせあてんしょうのくさり	【アビセア-天象の鎖】	顔文字
きょてんこうりゃく	【拠点攻略】	顔文字
ほきゅうぶたいきょうしゅう	【補給部隊強襲】	顔文字
きょてんぼうえい	【拠点防衛】	顔文字
ゆうぐんしえん	【友軍支援】	顔文字
きょてんていさつ	【拠点偵察】	顔文字
はかいこうさく	【破壊工作】	顔文字
へいしちょうれん	【兵士調練】	顔文字
ぐんじゅぶっししゅうしゅう	【軍需物資収集】	顔文字
ほきゅうぶっしちょうたつ	【補給物資調達】	顔文字
へいいんゆそう	【兵員輸送】	顔文字
ぐんじゅひんうんぱん	【軍需品運搬】	顔文字
しょくぎょうくんれん	【職業訓練】	顔文字
ぎじゅつきょうよ	【技術供与】	顔文字
ふしんぶつかいしゅう	【不審物回収】	顔文字
じゅんかいにんむ	【巡回任務】	顔文字
てきへいそうびていさつ	【敵兵装備偵察】	顔文字
てきぶっしごうだつ	【敵物資強奪】	顔文字
ゆそうけいかくりつあん	【輸送計画立案】	顔文字
きょてんぼうへきかいそう	【拠点防壁改装】	顔文字
こくたいしとうばつ	【黒太子討伐】	顔文字
くろたいしとうばつ	【黒太子討伐】	顔文字
こんごうおうとうばつ	【金剛王討伐】	顔文字
そくしんせいしんとうばつ	【即身成神討伐】	顔文字
やえいちきょうしゅう	【野営地強襲】	顔文字
ほんえいていさつ	【本営偵察】	顔文字
ふしょうへいきゅうじょ	【負傷兵救助】	顔文字
めいず	【メイズ】	顔文字
めいずもんがー	【メイズモンガー】	顔文字
もぶりんまーぶる	【モブリンマーブル】	顔文字
びちくこぞうちく	【備蓄庫増築】	顔文字
めりっとぽいんと	【メリットポイント】	顔文字
りみっとぽいんと	【リミットポイント】	顔文字
ふぃーるどおぶう゛ぁらー	【フィールド・オブ・ヴァラー】	顔文字
らーにんぐ	【ラーニング】	顔文字
もぐはうすしょうたい	【モグハウス招待】	顔文字
もぐさっちぇる	【モグサッチェル】	顔文字
おーぐめんと	【オーグメント】	顔文字
あだーゆにおん	【アダーユニオン】	顔文字
ばいそんゆにおん	【バイソンユニオン】	顔文字
こよーてゆにおん	【コヨーテユニオン】	顔文字
どーるゆにおん	【ドールユニオン】	顔文字
えらんどゆにおん	【エランドユニオン】	顔文字
じらーとのげんえい	【ジラートの幻影】	顔文字
ぷろましあのじゅばく	【プロマシアの呪縛】	顔文字
あとるがんのひほう	【アトルガンの秘宝】	顔文字
あるたなのしんぺい	【アルタナの神兵】	顔文字
いしのみるゆめ	【石の見る夢】	顔文字
せんりつもぐまつりのよる	【戦慄！モグ祭りの夜】	顔文字
しゃんとっとていこくのいんぼう	【シャントット帝国の陰謀】	顔文字
きんだんのちあびせあ	【禁断の地アビセア】	顔文字
あびせあのしとう	【アビセアの死闘】	顔文字
あびせあのはしゃ	【アビセアの覇者】	顔文字
